ARREST_DATE,YEAR,MONTH,F,M,V,TOTAL,FELONY_RATIO,OPACITY
2006-01-01,2006,1,164,348,32,544,0.3014705882352940,0.3014705882352940
2006-01-02,2006,1,168,418,29,615,0.2731707317073170,0.2731707317073170
2006-01-03,2006,1,300,556,36,892,0.336322869955157,0.336322869955157
2006-01-04,2006,1,341,829,51,1221,0.27927927927927900,0.27927927927927900
2006-01-05,2006,1,442,866,68,1376,0.32122093023255800,0.32122093023255800
2006-01-06,2006,1,398,774,66,1238,0.32148626817447500,0.32148626817447500
2006-01-07,2006,1,238,603,47,888,0.268018018018018,0.268018018018018
2006-01-08,2006,1,181,412,34,627,0.2886762360446570,0.2886762360446570
2006-01-09,2006,1,243,590,50,883,0.27519818799547000,0.27519818799547000
2006-01-10,2006,1,353,899,55,1307,0.2700841622035200,0.2700841622035200
2006-01-11,2006,1,356,810,49,1215,0.29300411522633700,0.29300411522633700
2006-01-12,2006,1,385,814,59,1258,0.30604133545310000,0.30604133545310000
2006-01-13,2006,1,377,811,68,1256,0.3001592356687900,0.3001592356687900
2006-01-14,2006,1,232,575,39,846,0.27423167848699800,0.27423167848699800
2006-01-15,2006,1,128,321,28,477,0.26834381551362700,0.26834381551362700
2006-01-16,2006,1,155,519,32,706,0.21954674220963200,0.21954674220963200
2006-01-17,2006,1,335,749,42,1126,0.2975133214920070,0.2975133214920070
2006-01-18,2006,1,364,772,49,1185,0.3071729957805910,0.3071729957805910
2006-01-19,2006,1,424,816,63,1303,0.3254029163468920,0.3254029163468920
2006-01-20,2006,1,333,669,79,1081,0.3080481036077710,0.3080481036077710
2006-01-21,2006,1,221,631,56,908,0.2433920704845820,0.2433920704845820
2006-01-22,2006,1,150,500,50,700,0.21428571428571400,0.21428571428571400
2006-01-23,2006,1,204,610,35,849,0.24028268551236700,0.24028268551236700
2006-01-24,2006,1,336,869,61,1266,0.26540284360189600,0.26540284360189600
2006-01-25,2006,1,408,848,57,1313,0.31073876618431100,0.31073876618431100
2006-01-26,2006,1,350,828,66,1244,0.28135048231511300,0.28135048231511300
2006-01-27,2006,1,304,728,88,1120,0.2714285714285710,0.2714285714285710
2006-01-28,2006,1,252,632,74,958,0.2630480167014610,0.2630480167014610
2006-01-29,2006,1,163,469,46,678,0.24041297935103200,0.24041297935103200
2006-01-30,2006,1,204,551,48,803,0.25404732254047300,0.25404732254047300
2006-01-31,2006,1,271,669,53,993,0.2729103726082580,0.2729103726082580
2006-02-01,2006,2,394,898,54,1346,0.29271916790490300,0.29271916790490300
2006-02-02,2006,2,391,878,80,1349,0.28984432913269100,0.28984432913269100
2006-02-03,2006,2,343,834,111,1288,0.266304347826087,0.266304347826087
2006-02-04,2006,2,262,666,70,998,0.2625250501002000,0.2625250501002000
2006-02-05,2006,2,161,365,37,563,0.28596802841918300,0.28596802841918300
2006-02-06,2006,2,219,601,41,861,0.25435540069686400,0.25435540069686400
2006-02-07,2006,2,326,901,63,1290,0.2527131782945740,0.2527131782945740
2006-02-08,2006,2,401,959,67,1427,0.28100911002102300,0.28100911002102300
2006-02-09,2006,2,373,880,70,1323,0.2819349962207110,0.2819349962207110
2006-02-10,2006,2,325,791,58,1174,0.2768313458262350,0.2768313458262350
2006-02-11,2006,2,209,558,47,814,0.25675675675675700,0.25675675675675700
2006-02-12,2006,2,57,172,4,233,0.2446351931330470,0.2446351931330470
2006-02-13,2006,2,137,442,37,616,0.2224025974025970,0.2224025974025970
2006-02-14,2006,2,223,626,64,913,0.244249726177437,0.244249726177437
2006-02-15,2006,2,379,922,62,1363,0.2780630961115190,0.2780630961115190
2006-02-16,2006,2,397,899,88,1384,0.28684971098265900,0.28684971098265900
2006-02-17,2006,2,347,821,64,1232,0.28165584415584400,0.28165584415584400
2006-02-18,2006,2,240,690,49,979,0.24514811031665000,0.24514811031665000
2006-02-19,2006,2,146,455,41,642,0.22741433021806900,0.22741433021806900
2006-02-20,2006,2,199,634,53,886,0.22460496613995500,0.22460496613995500
2006-02-21,2006,2,283,828,51,1162,0.24354561101549100,0.24354561101549100
2006-02-22,2006,2,399,890,73,1362,0.29295154185022000,0.29295154185022000
2006-02-23,2006,2,318,751,54,1123,0.2831700801424760,0.2831700801424760
2006-02-24,2006,2,312,700,55,1067,0.2924086223055300,0.2924086223055300
2006-02-25,2006,2,235,595,52,882,0.26643990929705200,0.26643990929705200
2006-02-26,2006,2,144,443,26,613,0.23491027732463300,0.23491027732463300
2006-02-27,2006,2,195,601,30,826,0.2360774818401940,0.2360774818401940
2006-02-28,2006,2,261,698,52,1011,0.258160237388724,0.258160237388724
2006-03-01,2006,3,387,920,52,1359,0.2847682119205300,0.2847682119205300
2006-03-02,2006,3,323,731,50,1104,0.29257246376811600,0.29257246376811600
2006-03-03,2006,3,373,806,51,1230,0.3032520325203250,0.3032520325203250
2006-03-04,2006,3,228,670,56,954,0.2389937106918240,0.2389937106918240
2006-03-05,2006,3,164,497,53,714,0.22969187675070000,0.22969187675070000
2006-03-06,2006,3,234,635,57,926,0.2526997840172790,0.2526997840172790
2006-03-07,2006,3,306,872,53,1231,0.24857839155158400,0.24857839155158400
2006-03-08,2006,3,364,974,66,1404,0.25925925925925900,0.25925925925925900
2006-03-09,2006,3,393,887,64,1344,0.2924107142857140,0.2924107142857140
2006-03-10,2006,3,371,813,71,1255,0.29561752988047800,0.29561752988047800
2006-03-11,2006,3,262,697,72,1031,0.2541222114451990,0.2541222114451990
2006-03-12,2006,3,180,399,48,627,0.28708133971291900,0.28708133971291900
2006-03-13,2006,3,255,638,57,950,0.26842105263157900,0.26842105263157900
2006-03-14,2006,3,295,827,56,1178,0.25042444821731700,0.25042444821731700
2006-03-15,2006,3,380,961,78,1419,0.2677942212825930,0.2677942212825930
2006-03-16,2006,3,353,905,70,1328,0.26581325301204800,0.26581325301204800
2006-03-17,2006,3,241,680,47,968,0.24896694214876000,0.24896694214876000
2006-03-18,2006,3,255,619,41,915,0.2786885245901640,0.2786885245901640
2006-03-19,2006,3,144,495,38,677,0.21270310192023600,0.21270310192023600
2006-03-20,2006,3,244,656,52,952,0.25630252100840300,0.25630252100840300
2006-03-21,2006,3,341,837,49,1227,0.27791361043194800,0.27791361043194800
2006-03-22,2006,3,383,933,66,1382,0.2771345875542690,0.2771345875542690
2006-03-23,2006,3,346,868,71,1285,0.26926070038910500,0.26926070038910500
2006-03-24,2006,3,371,753,58,1182,0.31387478849407800,0.31387478849407800
2006-03-25,2006,3,230,640,52,922,0.24945770065075900,0.24945770065075900
2006-03-26,2006,3,163,454,51,668,0.2440119760479040,0.2440119760479040
2006-03-27,2006,3,199,576,44,819,0.24297924297924300,0.24297924297924300
2006-03-28,2006,3,341,782,59,1182,0.28849407783417900,0.28849407783417900
2006-03-29,2006,3,370,893,64,1327,0.2788244159758860,0.2788244159758860
2006-03-30,2006,3,323,795,69,1187,0.2721145745577090,0.2721145745577090
2006-03-31,2006,3,252,677,67,996,0.25301204819277100,0.25301204819277100
2006-04-01,2006,4,296,658,54,1008,0.29365079365079400,0.29365079365079400
2006-04-02,2006,4,167,443,39,649,0.2573189522342070,0.2573189522342070
2006-04-03,2006,4,226,555,40,821,0.27527405602923300,0.27527405602923300
2006-04-04,2006,4,355,840,51,1246,0.28491171749598700,0.28491171749598700
2006-04-05,2006,4,415,949,52,1416,0.2930790960451980,0.2930790960451980
2006-04-06,2006,4,384,869,60,1313,0.2924600152322930,0.2924600152322930
2006-04-07,2006,4,375,769,79,1223,0.30662305805396600,0.30662305805396600
2006-04-08,2006,4,266,577,51,894,0.2975391498881430,0.2975391498881430
2006-04-09,2006,4,179,495,63,737,0.24287652645861600,0.24287652645861600
2006-04-10,2006,4,187,585,32,804,0.2325870646766170,0.2325870646766170
2006-04-11,2006,4,341,771,69,1181,0.2887383573243010,0.2887383573243010
2006-04-12,2006,4,367,919,67,1353,0.2712490761271250,0.2712490761271250
2006-04-13,2006,4,416,927,54,1397,0.297780959198282,0.297780959198282
2006-04-14,2006,4,308,773,54,1135,0.2713656387665200,0.2713656387665200
2006-04-15,2006,4,205,588,61,854,0.24004683840749400,0.24004683840749400
2006-04-16,2006,4,93,263,26,382,0.24345549738219900,0.24345549738219900
2006-04-17,2006,4,227,517,27,771,0.29442282749675700,0.29442282749675700
2006-04-18,2006,4,296,803,42,1141,0.25942156003505700,0.25942156003505700
2006-04-19,2006,4,377,854,62,1293,0.29156999226604800,0.29156999226604800
2006-04-20,2006,4,346,867,56,1269,0.272655634357762,0.272655634357762
2006-04-21,2006,4,323,683,43,1049,0.30791229742612000,0.30791229742612000
2006-04-22,2006,4,227,485,14,726,0.31267217630854000,0.31267217630854000
2006-04-23,2006,4,145,415,30,590,0.2457627118644070,0.2457627118644070
2006-04-24,2006,4,224,562,46,832,0.2692307692307690,0.2692307692307690
2006-04-25,2006,4,350,842,67,1259,0.2779984114376490,0.2779984114376490
2006-04-26,2006,4,414,860,62,1336,0.30988023952095800,0.30988023952095800
2006-04-27,2006,4,337,833,128,1298,0.2596302003081660,0.2596302003081660
2006-04-28,2006,4,378,688,54,1120,0.3375,0.3375
2006-04-29,2006,4,224,504,35,763,0.29357798165137600,0.29357798165137600
2006-04-30,2006,4,112,392,39,543,0.20626151012891300,0.20626151012891300
2006-05-01,2006,5,216,639,47,902,0.2394678492239470,0.2394678492239470
2006-05-02,2006,5,364,858,65,1287,0.2828282828282830,0.2828282828282830
2006-05-03,2006,5,401,932,60,1393,0.28786791098348900,0.28786791098348900
2006-05-04,2006,5,400,829,65,1294,0.3091190108191650,0.3091190108191650
2006-05-05,2006,5,276,784,63,1123,0.24577025823686600,0.24577025823686600
2006-05-06,2006,5,227,587,55,869,0.2612197928653630,0.2612197928653630
2006-05-07,2006,5,165,444,49,658,0.2507598784194530,0.2507598784194530
2006-05-08,2006,5,276,602,45,923,0.2990249187432290,0.2990249187432290
2006-05-09,2006,5,365,833,56,1254,0.29106858054226500,0.29106858054226500
2006-05-10,2006,5,416,879,86,1381,0.30123099203475700,0.30123099203475700
2006-05-11,2006,5,386,850,60,1296,0.2978395061728400,0.2978395061728400
2006-05-12,2006,5,331,721,79,1131,0.2926613616268790,0.2926613616268790
2006-05-13,2006,5,255,626,48,929,0.2744886975242200,0.2744886975242200
2006-05-14,2006,5,144,417,35,596,0.24161073825503400,0.24161073825503400
2006-05-15,2006,5,237,564,44,845,0.2804733727810650,0.2804733727810650
2006-05-16,2006,5,325,775,67,1167,0.27849185946872300,0.27849185946872300
2006-05-17,2006,5,349,917,96,1362,0.25624082232011700,0.25624082232011700
2006-05-18,2006,5,352,788,63,1203,0.29260182876143000,0.29260182876143000
2006-05-19,2006,5,293,605,53,951,0.30809674027339600,0.30809674027339600
2006-05-20,2006,5,250,610,49,909,0.27502750275027500,0.27502750275027500
2006-05-21,2006,5,131,419,48,598,0.21906354515050200,0.21906354515050200
2006-05-22,2006,5,193,600,47,840,0.22976190476190500,0.22976190476190500
2006-05-23,2006,5,358,859,53,1270,0.28188976377952800,0.28188976377952800
2006-05-24,2006,5,382,902,73,1357,0.2815033161385410,0.2815033161385410
2006-05-25,2006,5,390,851,87,1328,0.2936746987951810,0.2936746987951810
2006-05-26,2006,5,304,699,56,1059,0.2870632672332390,0.2870632672332390
2006-05-27,2006,5,220,547,52,819,0.2686202686202690,0.2686202686202690
2006-05-28,2006,5,127,401,51,579,0.21934369602763400,0.21934369602763400
2006-05-29,2006,5,113,327,43,483,0.23395445134575600,0.23395445134575600
2006-05-30,2006,5,290,736,41,1067,0.2717900656044990,0.2717900656044990
2006-05-31,2006,5,369,767,74,1210,0.3049586776859500,0.3049586776859500
2006-06-01,2006,6,332,791,68,1191,0.2787573467674220,0.2787573467674220
2006-06-02,2006,6,312,643,61,1016,0.30708661417322800,0.30708661417322800
2006-06-03,2006,6,235,532,48,815,0.2883435582822090,0.2883435582822090
2006-06-04,2006,6,166,417,43,626,0.26517571884984000,0.26517571884984000
2006-06-05,2006,6,247,606,38,891,0.2772166105499440,0.2772166105499440
2006-06-06,2006,6,358,794,67,1219,0.2936833470057420,0.2936833470057420
2006-06-07,2006,6,328,717,66,1111,0.2952295229522950,0.2952295229522950
2006-06-08,2006,6,380,809,69,1258,0.302066772655008,0.302066772655008
2006-06-09,2006,6,309,860,76,1245,0.24819277108433700,0.24819277108433700
2006-06-10,2006,6,204,574,48,826,0.2469733656174330,0.2469733656174330
2006-06-11,2006,6,163,542,36,741,0.21997300944669400,0.21997300944669400
2006-06-12,2006,6,242,624,42,908,0.2665198237885460,0.2665198237885460
2006-06-13,2006,6,355,816,64,1235,0.2874493927125510,0.2874493927125510
2006-06-14,2006,6,432,793,63,1288,0.33540372670807500,0.33540372670807500
2006-06-15,2006,6,428,791,45,1264,0.33860759493670900,0.33860759493670900
2006-06-16,2006,6,329,772,71,1172,0.28071672354948800,0.28071672354948800
2006-06-17,2006,6,226,645,46,917,0.24645583424209400,0.24645583424209400
2006-06-18,2006,6,116,284,30,430,0.26976744186046500,0.26976744186046500
2006-06-19,2006,6,197,578,46,821,0.23995127892813600,0.23995127892813600
2006-06-20,2006,6,356,819,49,1224,0.2908496732026140,0.2908496732026140
2006-06-21,2006,6,423,861,74,1358,0.3114874815905740,0.3114874815905740
2006-06-22,2006,6,392,780,80,1252,0.31309904153354600,0.31309904153354600
2006-06-23,2006,6,338,682,73,1093,0.3092406221408970,0.3092406221408970
2006-06-24,2006,6,223,492,43,758,0.2941952506596310,0.2941952506596310
2006-06-25,2006,6,155,398,34,587,0.26405451448040900,0.26405451448040900
2006-06-26,2006,6,235,557,63,855,0.27485380116959100,0.27485380116959100
2006-06-27,2006,6,298,687,66,1051,0.28353948620361600,0.28353948620361600
2006-06-28,2006,6,331,757,64,1152,0.2873263888888890,0.2873263888888890
2006-06-29,2006,6,271,732,66,1069,0.25350795135640800,0.25350795135640800
2006-06-30,2006,6,261,565,67,893,0.29227323628219500,0.29227323628219500
2006-07-01,2006,7,259,528,57,844,0.3068720379146920,0.3068720379146920
2006-07-02,2006,7,177,434,56,667,0.2653673163418290,0.2653673163418290
2006-07-03,2006,7,187,529,46,762,0.24540682414698200,0.24540682414698200
2006-07-04,2006,7,168,522,47,737,0.22795115332428800,0.22795115332428800
2006-07-05,2006,7,339,780,57,1176,0.288265306122449,0.288265306122449
2006-07-06,2006,7,348,887,76,1311,0.2654462242562930,0.2654462242562930
2006-07-07,2006,7,316,750,76,1142,0.276707530647986,0.276707530647986
2006-07-08,2006,7,289,621,65,975,0.2964102564102560,0.2964102564102560
2006-07-09,2006,7,153,431,53,637,0.2401883830455260,0.2401883830455260
2006-07-10,2006,7,232,557,41,830,0.27951807228915700,0.27951807228915700
2006-07-11,2006,7,352,775,85,1212,0.29042904290429000,0.29042904290429000
2006-07-12,2006,7,379,776,63,1218,0.3111658456486040,0.3111658456486040
2006-07-13,2006,7,361,874,72,1307,0.27620504973221100,0.27620504973221100
2006-07-14,2006,7,335,747,86,1168,0.2868150684931510,0.2868150684931510
2006-07-15,2006,7,249,548,58,855,0.2912280701754390,0.2912280701754390
2006-07-16,2006,7,173,474,56,703,0.2460881934566150,0.2460881934566150
2006-07-17,2006,7,213,541,44,798,0.2669172932330830,0.2669172932330830
2006-07-18,2006,7,336,714,48,1098,0.30601092896174900,0.30601092896174900
2006-07-19,2006,7,434,856,49,1339,0.3241224794622850,0.3241224794622850
2006-07-20,2006,7,384,832,71,1287,0.29836829836829800,0.29836829836829800
2006-07-21,2006,7,282,665,70,1017,0.27728613569321500,0.27728613569321500
2006-07-22,2006,7,271,482,59,812,0.33374384236453200,0.33374384236453200
2006-07-23,2006,7,154,399,52,605,0.2545454545454550,0.2545454545454550
2006-07-24,2006,7,206,571,52,829,0.24849215922798600,0.24849215922798600
2006-07-25,2006,7,360,811,55,1226,0.2936378466557910,0.2936378466557910
2006-07-26,2006,7,351,836,70,1257,0.27923627684964200,0.27923627684964200
2006-07-27,2006,7,340,738,70,1148,0.2961672473867600,0.2961672473867600
2006-07-28,2006,7,309,744,82,1135,0.27224669603524200,0.27224669603524200
2006-07-29,2006,7,245,547,43,835,0.2934131736526950,0.2934131736526950
2006-07-30,2006,7,169,395,51,615,0.27479674796748000,0.27479674796748000
2006-07-31,2006,7,220,444,39,703,0.3129445234708390,0.3129445234708390
2006-08-01,2006,8,308,669,52,1029,0.29931972789115600,0.29931972789115600
2006-08-02,2006,8,323,727,55,1105,0.2923076923076920,0.2923076923076920
2006-08-03,2006,8,355,818,74,1247,0.2846832397754610,0.2846832397754610
2006-08-04,2006,8,331,781,74,1186,0.2790893760539630,0.2790893760539630
2006-08-05,2006,8,267,604,69,940,0.28404255319148900,0.28404255319148900
2006-08-06,2006,8,172,428,33,633,0.2717219589257500,0.2717219589257500
2006-08-07,2006,8,207,563,56,826,0.2506053268765130,0.2506053268765130
2006-08-08,2006,8,396,812,59,1267,0.31254932912391500,0.31254932912391500
2006-08-09,2006,8,425,880,73,1378,0.3084179970972420,0.3084179970972420
2006-08-10,2006,8,322,822,58,1202,0.26788685524126500,0.26788685524126500
2006-08-11,2006,8,297,810,80,1187,0.2502106149957880,0.2502106149957880
2006-08-12,2006,8,285,616,71,972,0.2932098765432100,0.2932098765432100
2006-08-13,2006,8,156,487,50,693,0.22510822510822500,0.22510822510822500
2006-08-14,2006,8,212,558,51,821,0.2582216808769790,0.2582216808769790
2006-08-15,2006,8,345,770,78,1193,0.28918692372171000,0.28918692372171000
2006-08-16,2006,8,357,958,82,1397,0.25554760200429500,0.25554760200429500
2006-08-17,2006,8,335,826,83,1244,0.2692926045016080,0.2692926045016080
2006-08-18,2006,8,289,781,73,1143,0.25284339457567800,0.25284339457567800
2006-08-19,2006,8,267,566,55,888,0.30067567567567600,0.30067567567567600
2006-08-20,2006,8,173,486,42,701,0.24679029957204000,0.24679029957204000
2006-08-21,2006,8,221,534,61,816,0.2708333333333330,0.2708333333333330
2006-08-22,2006,8,328,704,79,1111,0.2952295229522950,0.2952295229522950
2006-08-23,2006,8,374,838,72,1284,0.29127725856697800,0.29127725856697800
2006-08-24,2006,8,340,806,74,1220,0.2786885245901640,0.2786885245901640
2006-08-25,2006,8,320,678,53,1051,0.3044719314938150,0.3044719314938150
2006-08-26,2006,8,235,573,46,854,0.275175644028103,0.275175644028103
2006-08-27,2006,8,147,409,48,604,0.2433774834437090,0.2433774834437090
2006-08-28,2006,8,170,511,48,729,0.23319615912208500,0.23319615912208500
2006-08-29,2006,8,254,626,37,917,0.27699018538713200,0.27699018538713200
2006-08-30,2006,8,373,809,71,1253,0.29768555466879500,0.29768555466879500
2006-08-31,2006,8,284,735,54,1073,0.2646784715750230,0.2646784715750230
2006-09-01,2006,9,331,705,66,1102,0.3003629764065340,0.3003629764065340
2006-09-02,2006,9,191,514,44,749,0.25500667556742300,0.25500667556742300
2006-09-03,2006,9,151,448,53,652,0.23159509202454000,0.23159509202454000
2006-09-04,2006,9,186,427,45,658,0.2826747720364740,0.2826747720364740
2006-09-05,2006,9,262,680,48,990,0.26464646464646500,0.26464646464646500
2006-09-06,2006,9,377,885,70,1332,0.283033033033033,0.283033033033033
2006-09-07,2006,9,354,827,83,1264,0.2800632911392410,0.2800632911392410
2006-09-08,2006,9,323,797,101,1221,0.26453726453726500,0.26453726453726500
2006-09-09,2006,9,274,643,56,973,0.2816032887975330,0.2816032887975330
2006-09-10,2006,9,168,402,50,620,0.2709677419354840,0.2709677419354840
2006-09-11,2006,9,183,476,43,702,0.2606837606837610,0.2606837606837610
2006-09-12,2006,9,226,549,49,824,0.27427184466019400,0.27427184466019400
2006-09-13,2006,9,350,964,79,1393,0.25125628140703500,0.25125628140703500
2006-09-14,2006,9,335,771,71,1177,0.28462192013593900,0.28462192013593900
2006-09-15,2006,9,286,736,62,1084,0.26383763837638400,0.26383763837638400
2006-09-16,2006,9,282,608,73,963,0.29283489096573200,0.29283489096573200
2006-09-17,2006,9,199,391,50,640,0.3109375,0.3109375
2006-09-18,2006,9,223,576,41,840,0.2654761904761910,0.2654761904761910
2006-09-19,2006,9,292,699,62,1053,0.27730294396961100,0.27730294396961100
2006-09-20,2006,9,333,773,55,1161,0.2868217054263570,0.2868217054263570
2006-09-21,2006,9,352,776,61,1189,0.2960470984020190,0.2960470984020190
2006-09-22,2006,9,269,653,74,996,0.2700803212851410,0.2700803212851410
2006-09-23,2006,9,281,618,66,965,0.2911917098445600,0.2911917098445600
2006-09-24,2006,9,186,473,60,719,0.25869262865090400,0.25869262865090400
2006-09-25,2006,9,245,581,54,880,0.2784090909090910,0.2784090909090910
2006-09-26,2006,9,345,864,58,1267,0.27229676400947100,0.27229676400947100
2006-09-27,2006,9,419,897,67,1383,0.3029645697758500,0.3029645697758500
2006-09-28,2006,9,324,889,100,1313,0.24676313785224700,0.24676313785224700
2006-09-29,2006,9,299,787,59,1145,0.2611353711790390,0.2611353711790390
2006-09-30,2006,9,296,607,47,950,0.31157894736842100,0.31157894736842100
2006-10-01,2006,10,212,466,40,718,0.29526462395543200,0.29526462395543200
2006-10-02,2006,10,237,633,55,925,0.2562162162162160,0.2562162162162160
2006-10-03,2006,10,372,829,56,1257,0.29594272076372300,0.29594272076372300
2006-10-04,2006,10,400,898,79,1377,0.29048656499636900,0.29048656499636900
2006-10-05,2006,10,370,762,75,1207,0.30654515327257700,0.30654515327257700
2006-10-06,2006,10,380,845,74,1299,0.2925327174749810,0.2925327174749810
2006-10-07,2006,10,298,701,57,1056,0.2821969696969700,0.2821969696969700
2006-10-08,2006,10,162,472,37,671,0.2414307004470940,0.2414307004470940
2006-10-09,2006,10,241,580,50,871,0.2766934557979330,0.2766934557979330
2006-10-10,2006,10,374,827,70,1271,0.2942564909520060,0.2942564909520060
2006-10-11,2006,10,324,716,39,1079,0.3002780352177940,0.3002780352177940
2006-10-12,2006,10,423,920,69,1412,0.29957507082153000,0.29957507082153000
2006-10-13,2006,10,403,794,52,1249,0.32265812650120100,0.32265812650120100
2006-10-14,2006,10,317,597,33,947,0.3347412882787750,0.3347412882787750
2006-10-15,2006,10,189,515,37,741,0.2550607287449390,0.2550607287449390
2006-10-16,2006,10,248,588,48,884,0.28054298642533900,0.28054298642533900
2006-10-17,2006,10,308,711,49,1068,0.2883895131086140,0.2883895131086140
2006-10-18,2006,10,415,876,55,1346,0.3083209509658250,0.3083209509658250
2006-10-19,2006,10,361,769,101,1231,0.2932575142160850,0.2932575142160850
2006-10-20,2006,10,386,746,67,1199,0.3219349457881570,0.3219349457881570
2006-10-21,2006,10,277,671,50,998,0.2775551102204410,0.2775551102204410
2006-10-22,2006,10,176,493,51,720,0.24444444444444400,0.24444444444444400
2006-10-23,2006,10,210,567,42,819,0.2564102564102560,0.2564102564102560
2006-10-24,2006,10,302,855,56,1213,0.24896949711459200,0.24896949711459200
2006-10-25,2006,10,420,924,76,1420,0.29577464788732400,0.29577464788732400
2006-10-26,2006,10,408,803,68,1279,0.3189992181391710,0.3189992181391710
2006-10-27,2006,10,351,757,54,1162,0.30206540447504300,0.30206540447504300
2006-10-28,2006,10,244,509,46,799,0.3053817271589490,0.3053817271589490
2006-10-29,2006,10,172,433,42,647,0.26584234930448200,0.26584234930448200
2006-10-30,2006,10,216,542,48,806,0.2679900744416870,0.2679900744416870
2006-10-31,2006,10,265,533,53,851,0.31139835487661600,0.31139835487661600
2006-11-01,2006,11,404,911,58,1373,0.2942461762563730,0.2942461762563730
2006-11-02,2006,11,368,790,60,1218,0.3021346469622330,0.3021346469622330
2006-11-03,2006,11,400,772,60,1232,0.3246753246753250,0.3246753246753250
2006-11-04,2006,11,241,651,41,933,0.2583065380493030,0.2583065380493030
2006-11-05,2006,11,170,446,46,662,0.256797583081571,0.256797583081571
2006-11-06,2006,11,203,571,49,823,0.24665856622114200,0.24665856622114200
2006-11-07,2006,11,278,598,41,917,0.3031624863685930,0.3031624863685930
2006-11-08,2006,11,282,655,49,986,0.28600405679513200,0.28600405679513200
2006-11-09,2006,11,476,990,85,1551,0.30689877498388100,0.30689877498388100
2006-11-10,2006,11,385,915,67,1367,0.2816386247256770,0.2816386247256770
2006-11-11,2006,11,284,655,55,994,0.2857142857142860,0.2857142857142860
2006-11-12,2006,11,167,460,37,664,0.25150602409638600,0.25150602409638600
2006-11-13,2006,11,218,539,27,784,0.2780612244897960,0.2780612244897960
2006-11-14,2006,11,338,784,60,1182,0.2859560067681900,0.2859560067681900
2006-11-15,2006,11,392,854,89,1335,0.29363295880149800,0.29363295880149800
2006-11-16,2006,11,394,712,50,1156,0.3408304498269900,0.3408304498269900
2006-11-17,2006,11,363,792,57,1212,0.2995049504950500,0.2995049504950500
2006-11-18,2006,11,271,605,47,923,0.29360780065005400,0.29360780065005400
2006-11-19,2006,11,194,496,56,746,0.26005361930294900,0.26005361930294900
2006-11-20,2006,11,242,605,41,888,0.2725225225225230,0.2725225225225230
2006-11-21,2006,11,362,796,48,1206,0.30016583747927000,0.30016583747927000
2006-11-22,2006,11,268,559,33,860,0.3116279069767440,0.3116279069767440
2006-11-23,2006,11,67,172,9,248,0.2701612903225810,0.2701612903225810
2006-11-24,2006,11,255,643,29,927,0.2750809061488670,0.2750809061488670
2006-11-25,2006,11,258,642,38,938,0.27505330490405100,0.27505330490405100
2006-11-26,2006,11,165,445,29,639,0.25821596244131500,0.25821596244131500
2006-11-27,2006,11,234,550,37,821,0.2850182704019490,0.2850182704019490
2006-11-28,2006,11,348,773,43,1164,0.29896907216494800,0.29896907216494800
2006-11-29,2006,11,329,747,53,1129,0.2914083259521700,0.2914083259521700
2006-11-30,2006,11,332,749,60,1141,0.2909728308501320,0.2909728308501320
2006-12-01,2006,12,324,697,45,1066,0.30393996247654800,0.30393996247654800
2006-12-02,2006,12,272,628,45,945,0.2878306878306880,0.2878306878306880
2006-12-03,2006,12,154,457,41,652,0.2361963190184050,0.2361963190184050
2006-12-04,2006,12,238,598,25,861,0.2764227642276420,0.2764227642276420
2006-12-05,2006,12,367,759,38,1164,0.31529209621993100,0.31529209621993100
2006-12-06,2006,12,355,842,58,1255,0.28286852589641400,0.28286852589641400
2006-12-07,2006,12,305,811,48,1164,0.2620274914089350,0.2620274914089350
2006-12-08,2006,12,345,811,40,1196,0.28846153846153800,0.28846153846153800
2006-12-09,2006,12,242,646,32,920,0.26304347826087000,0.26304347826087000
2006-12-10,2006,12,146,466,36,648,0.22530864197530900,0.22530864197530900
2006-12-11,2006,12,225,579,51,855,0.2631578947368420,0.2631578947368420
2006-12-12,2006,12,378,844,34,1256,0.30095541401273900,0.30095541401273900
2006-12-13,2006,12,318,744,44,1106,0.2875226039783000,0.2875226039783000
2006-12-14,2006,12,301,714,54,1069,0.2815715622076710,0.2815715622076710
2006-12-15,2006,12,347,698,47,1092,0.31776556776556800,0.31776556776556800
2006-12-16,2006,12,217,506,36,759,0.2859025032938080,0.2859025032938080
2006-12-17,2006,12,169,467,37,673,0.2511144130757800,0.2511144130757800
2006-12-18,2006,12,184,529,33,746,0.24664879356568400,0.24664879356568400
2006-12-19,2006,12,323,782,38,1143,0.28258967629046400,0.28258967629046400
2006-12-20,2006,12,288,795,51,1134,0.25396825396825400,0.25396825396825400
2006-12-21,2006,12,284,707,38,1029,0.2759961127308070,0.2759961127308070
2006-12-22,2006,12,217,588,39,844,0.2571090047393370,0.2571090047393370
2006-12-23,2006,12,150,480,36,666,0.22522522522522500,0.22522522522522500
2006-12-24,2006,12,94,190,9,293,0.32081911262798600,0.32081911262798600
2006-12-25,2006,12,59,75,4,138,0.427536231884058,0.427536231884058
2006-12-26,2006,12,181,544,26,751,0.24101198402130500,0.24101198402130500
2006-12-27,2006,12,321,749,38,1108,0.2897111913357400,0.2897111913357400
2006-12-28,2006,12,363,690,40,1093,0.3321134492223240,0.3321134492223240
2006-12-29,2006,12,296,690,35,1021,0.2899118511263470,0.2899118511263470
2006-12-30,2006,12,142,496,28,666,0.2132132132132130,0.2132132132132130
2006-12-31,2006,12,119,262,16,397,0.29974811083123400,0.29974811083123400
2007-01-01,2007,1,188,371,25,584,0.3219178082191780,0.3219178082191780
2007-01-02,2007,1,337,808,33,1178,0.2860780984719860,0.2860780984719860
2007-01-03,2007,1,484,1022,53,1559,0.3104554201411160,0.3104554201411160
2007-01-04,2007,1,424,1080,50,1554,0.2728442728442730,0.2728442728442730
2007-01-05,2007,1,443,970,95,1508,0.2937665782493370,0.2937665782493370
2007-01-06,2007,1,309,804,63,1176,0.2627551020408160,0.2627551020408160
2007-01-07,2007,1,195,500,40,735,0.2653061224489800,0.2653061224489800
2007-01-08,2007,1,264,630,38,932,0.2832618025751070,0.2832618025751070
2007-01-09,2007,1,400,970,48,1418,0.2820874471086040,0.2820874471086040
2007-01-10,2007,1,418,970,70,1458,0.28669410150891600,0.28669410150891600
2007-01-11,2007,1,408,1006,54,1468,0.2779291553133520,0.2779291553133520
2007-01-12,2007,1,444,1021,74,1539,0.2884990253411310,0.2884990253411310
2007-01-13,2007,1,322,874,76,1272,0.2531446540880500,0.2531446540880500
2007-01-14,2007,1,172,566,69,807,0.21313506815365600,0.21313506815365600
2007-01-15,2007,1,227,704,53,984,0.2306910569105690,0.2306910569105690
2007-01-16,2007,1,438,925,73,1436,0.3050139275766020,0.3050139275766020
2007-01-17,2007,1,408,950,36,1394,0.2926829268292680,0.2926829268292680
2007-01-18,2007,1,493,1002,85,1580,0.3120253164556960,0.3120253164556960
2007-01-19,2007,1,385,959,71,1415,0.27208480565371000,0.27208480565371000
2007-01-20,2007,1,273,796,78,1147,0.23801220575414100,0.23801220575414100
2007-01-21,2007,1,163,526,58,747,0.2182061579651940,0.2182061579651940
2007-01-22,2007,1,205,662,71,938,0.21855010660980800,0.21855010660980800
2007-01-23,2007,1,366,962,59,1387,0.2638788752703680,0.2638788752703680
2007-01-24,2007,1,424,1000,79,1503,0.2821024617431800,0.2821024617431800
2007-01-25,2007,1,408,960,56,1424,0.28651685393258400,0.28651685393258400
2007-01-26,2007,1,348,747,63,1158,0.3005181347150260,0.3005181347150260
2007-01-27,2007,1,256,789,59,1104,0.2318840579710150,0.2318840579710150
2007-01-28,2007,1,190,560,51,801,0.23720349563046200,0.23720349563046200
2007-01-29,2007,1,186,549,36,771,0.24124513618677000,0.24124513618677000
2007-01-30,2007,1,324,763,51,1138,0.28471001757469200,0.28471001757469200
2007-01-31,2007,1,387,824,59,1270,0.3047244094488190,0.3047244094488190
2007-02-01,2007,2,453,888,61,1402,0.3231098430813120,0.3231098430813120
2007-02-02,2007,2,379,893,57,1329,0.28517682468021100,0.28517682468021100
2007-02-03,2007,2,242,612,55,909,0.2662266226622660,0.2662266226622660
2007-02-04,2007,2,136,410,31,577,0.23570190641247800,0.23570190641247800
2007-02-05,2007,2,188,516,30,734,0.2561307901907360,0.2561307901907360
2007-02-06,2007,2,317,842,49,1208,0.26241721854304600,0.26241721854304600
2007-02-07,2007,2,388,1052,55,1495,0.25953177257525100,0.25953177257525100
2007-02-08,2007,2,399,1082,73,1554,0.25675675675675700,0.25675675675675700
2007-02-09,2007,2,343,971,75,1389,0.24694024478041800,0.24694024478041800
2007-02-10,2007,2,287,848,52,1187,0.2417860151642800,0.2417860151642800
2007-02-11,2007,2,179,627,52,858,0.20862470862470900,0.20862470862470900
2007-02-12,2007,2,235,717,70,1022,0.2299412915851270,0.2299412915851270
2007-02-13,2007,2,360,951,43,1354,0.2658788774002950,0.2658788774002950
2007-02-14,2007,2,158,423,38,619,0.2552504038772210,0.2552504038772210
2007-02-15,2007,2,323,820,62,1205,0.2680497925311200,0.2680497925311200
2007-02-16,2007,2,297,817,58,1172,0.25341296928327600,0.25341296928327600
2007-02-17,2007,2,278,791,49,1118,0.24865831842576000,0.24865831842576000
2007-02-18,2007,2,166,536,37,739,0.22462787550744200,0.22462787550744200
2007-02-19,2007,2,195,650,36,881,0.2213393870601590,0.2213393870601590
2007-02-20,2007,2,373,880,71,1324,0.28172205438066500,0.28172205438066500
2007-02-21,2007,2,428,1093,91,1612,0.2655086848635240,0.2655086848635240
2007-02-22,2007,2,362,909,73,1344,0.2693452380952380,0.2693452380952380
2007-02-23,2007,2,298,859,59,1216,0.2450657894736840,0.2450657894736840
2007-02-24,2007,2,301,758,57,1116,0.26971326164874600,0.26971326164874600
2007-02-25,2007,2,154,560,54,768,0.20052083333333300,0.20052083333333300
2007-02-26,2007,2,224,565,39,828,0.27053140096618400,0.27053140096618400
2007-02-27,2007,2,392,1045,73,1510,0.2596026490066230,0.2596026490066230
2007-02-28,2007,2,443,963,71,1477,0.2999322951929590,0.2999322951929590
2007-03-01,2007,3,405,942,65,1412,0.2868271954674220,0.2868271954674220
2007-03-02,2007,3,363,856,75,1294,0.28052550231839300,0.28052550231839300
2007-03-03,2007,3,302,840,64,1206,0.2504145936981760,0.2504145936981760
2007-03-04,2007,3,181,589,44,814,0.22235872235872200,0.22235872235872200
2007-03-05,2007,3,212,675,40,927,0.22869471413160700,0.22869471413160700
2007-03-06,2007,3,308,791,52,1151,0.2675933970460470,0.2675933970460470
2007-03-07,2007,3,355,913,47,1315,0.26996197718631200,0.26996197718631200
2007-03-08,2007,3,354,943,56,1353,0.2616407982261640,0.2616407982261640
2007-03-09,2007,3,383,966,59,1408,0.27201704545454500,0.27201704545454500
2007-03-10,2007,3,297,792,82,1171,0.25362937660119600,0.25362937660119600
2007-03-11,2007,3,169,525,39,733,0.2305593451568900,0.2305593451568900
2007-03-12,2007,3,239,722,61,1022,0.23385518590998000,0.23385518590998000
2007-03-13,2007,3,284,937,67,1288,0.2204968944099380,0.2204968944099380
2007-03-14,2007,3,424,1032,79,1535,0.2762214983713360,0.2762214983713360
2007-03-15,2007,3,299,864,56,1219,0.24528301886792500,0.24528301886792500
2007-03-16,2007,3,211,457,32,700,0.30142857142857100,0.30142857142857100
2007-03-17,2007,3,162,466,40,668,0.24251497005988000,0.24251497005988000
2007-03-18,2007,3,153,437,42,632,0.24208860759493700,0.24208860759493700
2007-03-19,2007,3,174,532,72,778,0.2236503856041130,0.2236503856041130
2007-03-20,2007,3,382,883,78,1343,0.2844378257632170,0.2844378257632170
2007-03-21,2007,3,393,965,65,1423,0.27617709065354900,0.27617709065354900
2007-03-22,2007,3,358,987,85,1430,0.25034965034965000,0.25034965034965000
2007-03-23,2007,3,320,937,93,1350,0.23703703703703700,0.23703703703703700
2007-03-24,2007,3,283,734,70,1087,0.26034958601655900,0.26034958601655900
2007-03-25,2007,3,172,564,53,789,0.21799746514575400,0.21799746514575400
2007-03-26,2007,3,247,668,67,982,0.2515274949083500,0.2515274949083500
2007-03-27,2007,3,331,863,88,1282,0.2581903276131050,0.2581903276131050
2007-03-28,2007,3,401,984,92,1477,0.27149627623561300,0.27149627623561300
2007-03-29,2007,3,327,874,118,1319,0.24791508718726300,0.24791508718726300
2007-03-30,2007,3,308,815,59,1182,0.26057529610829100,0.26057529610829100
2007-03-31,2007,3,296,686,68,1050,0.2819047619047620,0.2819047619047620
2007-04-01,2007,4,177,505,46,728,0.24313186813186800,0.24313186813186800
2007-04-02,2007,4,186,547,55,788,0.23604060913705600,0.23604060913705600
2007-04-03,2007,4,335,892,63,1290,0.2596899224806200,0.2596899224806200
2007-04-04,2007,4,286,805,45,1136,0.2517605633802820,0.2517605633802820
2007-04-05,2007,4,336,887,73,1296,0.25925925925925900,0.25925925925925900
2007-04-06,2007,4,386,846,65,1297,0.29760986892829600,0.29760986892829600
2007-04-07,2007,4,238,664,63,965,0.24663212435233200,0.24663212435233200
2007-04-08,2007,4,93,310,38,441,0.2108843537414970,0.2108843537414970
2007-04-09,2007,4,207,592,43,842,0.24584323040380000,0.24584323040380000
2007-04-10,2007,4,283,875,72,1230,0.23008130081300800,0.23008130081300800
2007-04-11,2007,4,426,1000,77,1503,0.2834331337325350,0.2834331337325350
2007-04-12,2007,4,343,744,68,1155,0.296969696969697,0.296969696969697
2007-04-13,2007,4,369,966,82,1417,0.26040931545518700,0.26040931545518700
2007-04-14,2007,4,270,772,78,1120,0.24107142857142900,0.24107142857142900
2007-04-15,2007,4,115,376,29,520,0.22115384615384600,0.22115384615384600
2007-04-16,2007,4,208,539,33,780,0.26666666666666700,0.26666666666666700
2007-04-17,2007,4,347,929,80,1356,0.2558997050147490,0.2558997050147490
2007-04-18,2007,4,415,969,87,1471,0.2821210061182870,0.2821210061182870
2007-04-19,2007,4,428,983,100,1511,0.28325612177366000,0.28325612177366000
2007-04-20,2007,4,382,907,79,1368,0.27923976608187100,0.27923976608187100
2007-04-21,2007,4,246,711,79,1036,0.23745173745173700,0.23745173745173700
2007-04-22,2007,4,179,494,81,754,0.23740053050397900,0.23740053050397900
2007-04-23,2007,4,217,614,69,900,0.2411111111111110,0.2411111111111110
2007-04-24,2007,4,325,829,67,1221,0.26617526617526600,0.26617526617526600
2007-04-25,2007,4,405,943,82,1430,0.28321678321678300,0.28321678321678300
2007-04-26,2007,4,398,1029,67,1494,0.26639892904953100,0.26639892904953100
2007-04-27,2007,4,371,772,69,1212,0.3061056105610560,0.3061056105610560
2007-04-28,2007,4,262,703,81,1046,0.25047801147227500,0.25047801147227500
2007-04-29,2007,4,170,488,74,732,0.23224043715847000,0.23224043715847000
2007-04-30,2007,4,229,629,60,918,0.2494553376906320,0.2494553376906320
2007-05-01,2007,5,317,873,96,1286,0.24650077760497700,0.24650077760497700
2007-05-02,2007,5,423,962,88,1473,0.28716904276985700,0.28716904276985700
2007-05-03,2007,5,382,1015,99,1496,0.2553475935828880,0.2553475935828880
2007-05-04,2007,5,353,816,78,1247,0.2830793905372900,0.2830793905372900
2007-05-05,2007,5,252,624,62,938,0.26865671641791000,0.26865671641791000
2007-05-06,2007,5,180,524,51,755,0.23841059602649000,0.23841059602649000
2007-05-07,2007,5,252,594,65,911,0.27661909989023100,0.27661909989023100
2007-05-08,2007,5,352,846,73,1271,0.2769472856018880,0.2769472856018880
2007-05-09,2007,5,398,1045,94,1537,0.25894599869876400,0.25894599869876400
2007-05-10,2007,5,449,856,91,1396,0.3216332378223500,0.3216332378223500
2007-05-11,2007,5,377,924,78,1379,0.27338651196519200,0.27338651196519200
2007-05-12,2007,5,253,711,65,1029,0.24586977648202100,0.24586977648202100
2007-05-13,2007,5,153,403,49,605,0.2528925619834710,0.2528925619834710
2007-05-14,2007,5,221,686,45,952,0.23214285714285700,0.23214285714285700
2007-05-15,2007,5,380,869,79,1328,0.286144578313253,0.286144578313253
2007-05-16,2007,5,387,962,95,1444,0.268005540166205,0.268005540166205
2007-05-17,2007,5,430,929,128,1487,0.28917283120376600,0.28917283120376600
2007-05-18,2007,5,361,803,82,1246,0.2897271268057790,0.2897271268057790
2007-05-19,2007,5,289,619,48,956,0.3023012552301260,0.3023012552301260
2007-05-20,2007,5,151,484,53,688,0.2194767441860470,0.2194767441860470
2007-05-21,2007,5,214,576,60,850,0.25176470588235300,0.25176470588235300
2007-05-22,2007,5,320,881,68,1269,0.25216706067769900,0.25216706067769900
2007-05-23,2007,5,408,956,88,1452,0.2809917355371900,0.2809917355371900
2007-05-24,2007,5,307,840,101,1248,0.24599358974359000,0.24599358974359000
2007-05-25,2007,5,355,691,73,1119,0.31724754244861500,0.31724754244861500
2007-05-26,2007,5,233,650,69,952,0.24474789915966400,0.24474789915966400
2007-05-27,2007,5,169,391,37,597,0.2830820770519260,0.2830820770519260
2007-05-28,2007,5,126,393,36,555,0.22702702702702700,0.22702702702702700
2007-05-29,2007,5,316,895,78,1289,0.2451512800620640,0.2451512800620640
2007-05-30,2007,5,394,835,80,1309,0.3009931245225360,0.3009931245225360
2007-05-31,2007,5,360,797,76,1233,0.291970802919708,0.291970802919708
2007-06-01,2007,6,361,823,98,1282,0.28159126365054600,0.28159126365054600
2007-06-02,2007,6,253,674,71,998,0.2535070140280560,0.2535070140280560
2007-06-03,2007,6,157,417,38,612,0.2565359477124180,0.2565359477124180
2007-06-04,2007,6,189,547,48,784,0.24107142857142900,0.24107142857142900
2007-06-05,2007,6,365,898,80,1343,0.2717795979151150,0.2717795979151150
2007-06-06,2007,6,399,938,105,1442,0.2766990291262140,0.2766990291262140
2007-06-07,2007,6,378,843,102,1323,0.2857142857142860,0.2857142857142860
2007-06-08,2007,6,393,726,91,1210,0.3247933884297520,0.3247933884297520
2007-06-09,2007,6,271,582,80,933,0.2904608788853160,0.2904608788853160
2007-06-10,2007,6,137,625,87,849,0.16136631330977600,0.16136631330977600
2007-06-11,2007,6,247,550,51,848,0.29127358490566000,0.29127358490566000
2007-06-12,2007,6,364,734,56,1154,0.31542461005199300,0.31542461005199300
2007-06-13,2007,6,431,897,85,1413,0.3050247699929230,0.3050247699929230
2007-06-14,2007,6,391,869,86,1346,0.29049034175334300,0.29049034175334300
2007-06-15,2007,6,362,802,79,1243,0.2912308930008050,0.2912308930008050
2007-06-16,2007,6,248,612,53,913,0.27163198247535600,0.27163198247535600
2007-06-17,2007,6,144,378,50,572,0.2517482517482520,0.2517482517482520
2007-06-18,2007,6,247,610,65,922,0.2678958785249460,0.2678958785249460
2007-06-19,2007,6,356,834,79,1269,0.2805358550039400,0.2805358550039400
2007-06-20,2007,6,366,869,92,1327,0.27581009796533500,0.27581009796533500
2007-06-21,2007,6,416,921,92,1429,0.29111266620014,0.29111266620014
2007-06-22,2007,6,355,789,67,1211,0.2931461601981830,0.2931461601981830
2007-06-23,2007,6,283,689,62,1034,0.2736943907156670,0.2736943907156670
2007-06-24,2007,6,195,480,50,725,0.2689655172413790,0.2689655172413790
2007-06-25,2007,6,203,589,44,836,0.24282296650717700,0.24282296650717700
2007-06-26,2007,6,348,806,71,1225,0.28408163265306100,0.28408163265306100
2007-06-27,2007,6,319,807,82,1208,0.2640728476821190,0.2640728476821190
2007-06-28,2007,6,310,676,79,1065,0.29107981220657300,0.29107981220657300
2007-06-29,2007,6,289,690,67,1046,0.2762906309751430,0.2762906309751430
2007-06-30,2007,6,206,626,67,899,0.22914349276974400,0.22914349276974400
2007-07-01,2007,7,172,461,46,679,0.2533136966126660,0.2533136966126660
2007-07-02,2007,7,274,555,51,880,0.31136363636363600,0.31136363636363600
2007-07-03,2007,7,325,769,66,1160,0.2801724137931030,0.2801724137931030
2007-07-04,2007,7,228,565,66,859,0.26542491268917300,0.26542491268917300
2007-07-05,2007,7,375,825,95,1295,0.28957528957529000,0.28957528957529000
2007-07-06,2007,7,374,832,79,1285,0.29105058365758800,0.29105058365758800
2007-07-07,2007,7,259,658,70,987,0.2624113475177310,0.2624113475177310
2007-07-08,2007,7,157,407,80,644,0.24378881987577600,0.24378881987577600
2007-07-09,2007,7,203,555,70,828,0.24516908212560400,0.24516908212560400
2007-07-10,2007,7,323,819,86,1228,0.26302931596091200,0.26302931596091200
2007-07-11,2007,7,400,958,81,1439,0.27797081306462800,0.27797081306462800
2007-07-12,2007,7,353,915,100,1368,0.2580409356725150,0.2580409356725150
2007-07-13,2007,7,364,859,82,1305,0.2789272030651340,0.2789272030651340
2007-07-14,2007,7,313,606,74,993,0.3152064451158110,0.3152064451158110
2007-07-15,2007,7,130,433,58,621,0.20933977455716600,0.20933977455716600
2007-07-16,2007,7,247,546,63,856,0.2885514018691590,0.2885514018691590
2007-07-17,2007,7,337,804,72,1213,0.27782357790601800,0.27782357790601800
2007-07-18,2007,7,359,760,77,1196,0.3001672240802680,0.3001672240802680
2007-07-19,2007,7,209,509,72,790,0.2645569620253170,0.2645569620253170
2007-07-20,2007,7,355,843,90,1288,0.27562111801242200,0.27562111801242200
2007-07-21,2007,7,299,664,74,1037,0.28833172613307600,0.28833172613307600
2007-07-22,2007,7,198,449,68,715,0.27692307692307700,0.27692307692307700
2007-07-23,2007,7,212,476,42,730,0.29041095890411000,0.29041095890411000
2007-07-24,2007,7,313,866,82,1261,0.24821570182394900,0.24821570182394900
2007-07-25,2007,7,429,894,86,1409,0.3044712562100780,0.3044712562100780
2007-07-26,2007,7,390,823,85,1298,0.300462249614792,0.300462249614792
2007-07-27,2007,7,348,759,80,1187,0.2931760741364790,0.2931760741364790
2007-07-28,2007,7,266,656,74,996,0.26706827309236900,0.26706827309236900
2007-07-29,2007,7,165,427,56,648,0.25462962962963000,0.25462962962963000
2007-07-30,2007,7,194,532,52,778,0.2493573264781490,0.2493573264781490
2007-07-31,2007,7,343,832,83,1258,0.2726550079491260,0.2726550079491260
2007-08-01,2007,8,433,967,99,1499,0.28885923949299500,0.28885923949299500
2007-08-02,2007,8,373,863,108,1344,0.2775297619047620,0.2775297619047620
2007-08-03,2007,8,406,833,79,1318,0.30804248861912000,0.30804248861912000
2007-08-04,2007,8,281,658,85,1024,0.2744140625,0.2744140625
2007-08-05,2007,8,179,453,73,705,0.25390070921985800,0.25390070921985800
2007-08-06,2007,8,239,548,73,860,0.2779069767441860,0.2779069767441860
2007-08-07,2007,8,394,834,85,1313,0.3000761614623000,0.3000761614623000
2007-08-08,2007,8,365,800,64,1229,0.2969894222945480,0.2969894222945480
2007-08-09,2007,8,379,842,113,1334,0.2841079460269870,0.2841079460269870
2007-08-10,2007,8,373,759,60,1192,0.31291946308724800,0.31291946308724800
2007-08-11,2007,8,263,734,82,1079,0.24374420759962900,0.24374420759962900
2007-08-12,2007,8,192,503,72,767,0.2503259452412000,0.2503259452412000
2007-08-13,2007,8,225,550,59,834,0.2697841726618710,0.2697841726618710
2007-08-14,2007,8,409,858,63,1330,0.3075187969924810,0.3075187969924810
2007-08-15,2007,8,349,879,95,1323,0.2637944066515500,0.2637944066515500
2007-08-16,2007,8,388,839,117,1344,0.28869047619047600,0.28869047619047600
2007-08-17,2007,8,392,779,103,1274,0.3076923076923080,0.3076923076923080
2007-08-18,2007,8,315,686,89,1090,0.2889908256880730,0.2889908256880730
2007-08-19,2007,8,162,491,57,710,0.22816901408450700,0.22816901408450700
2007-08-20,2007,8,232,497,40,769,0.3016905071521460,0.3016905071521460
2007-08-21,2007,8,322,714,62,1098,0.29326047358834200,0.29326047358834200
2007-08-22,2007,8,427,929,96,1452,0.2940771349862260,0.2940771349862260
2007-08-23,2007,8,411,838,93,1342,0.30625931445603600,0.30625931445603600
2007-08-24,2007,8,395,783,99,1277,0.3093187157400160,0.3093187157400160
2007-08-25,2007,8,272,697,90,1059,0.25684608120868700,0.25684608120868700
2007-08-26,2007,8,173,515,57,745,0.23221476510067100,0.23221476510067100
2007-08-27,2007,8,233,569,55,857,0.2718786464410740,0.2718786464410740
2007-08-28,2007,8,324,722,72,1118,0.2898032200357780,0.2898032200357780
2007-08-29,2007,8,366,810,106,1282,0.28549141965678600,0.28549141965678600
2007-08-30,2007,8,383,689,92,1164,0.3290378006872850,0.3290378006872850
2007-08-31,2007,8,340,770,72,1182,0.2876480541455160,0.2876480541455160
2007-09-01,2007,9,289,685,75,1049,0.2755004766444230,0.2755004766444230
2007-09-02,2007,9,186,443,63,692,0.26878612716763000,0.26878612716763000
2007-09-03,2007,9,172,355,24,551,0.3121597096188750,0.3121597096188750
2007-09-04,2007,9,286,709,75,1070,0.2672897196261680,0.2672897196261680
2007-09-05,2007,9,354,798,83,1235,0.28663967611336000,0.28663967611336000
2007-09-06,2007,9,402,805,97,1304,0.30828220858895700,0.30828220858895700
2007-09-07,2007,9,357,812,79,1248,0.2860576923076920,0.2860576923076920
2007-09-08,2007,9,284,760,75,1119,0.2537980339588920,0.2537980339588920
2007-09-09,2007,9,172,562,54,788,0.2182741116751270,0.2182741116751270
2007-09-10,2007,9,216,540,56,812,0.2660098522167490,0.2660098522167490
2007-09-11,2007,9,382,682,67,1131,0.33775419982316500,0.33775419982316500
2007-09-12,2007,9,457,973,87,1517,0.3012524719841790,0.3012524719841790
2007-09-13,2007,9,407,948,90,1445,0.2816608996539790,0.2816608996539790
2007-09-14,2007,9,377,913,83,1373,0.2745812090313180,0.2745812090313180
2007-09-15,2007,9,301,655,81,1037,0.29026036644165900,0.29026036644165900
2007-09-16,2007,9,193,545,71,809,0.23856613102595800,0.23856613102595800
2007-09-17,2007,9,254,531,48,833,0.304921968787515,0.304921968787515
2007-09-18,2007,9,326,705,86,1117,0.2918531781557740,0.2918531781557740
2007-09-19,2007,9,412,909,101,1422,0.28973277074542900,0.28973277074542900
2007-09-20,2007,9,413,874,113,1400,0.295,0.295
2007-09-21,2007,9,342,837,93,1272,0.2688679245283020,0.2688679245283020
2007-09-22,2007,9,273,674,61,1008,0.2708333333333330,0.2708333333333330
2007-09-23,2007,9,179,557,71,807,0.2218091697645600,0.2218091697645600
2007-09-24,2007,9,194,518,55,767,0.2529335071707950,0.2529335071707950
2007-09-25,2007,9,365,705,83,1153,0.3165654813529920,0.3165654813529920
2007-09-26,2007,9,327,758,74,1159,0.28213977566868000,0.28213977566868000
2007-09-27,2007,9,334,797,62,1193,0.2799664710813080,0.2799664710813080
2007-09-28,2007,9,333,745,69,1147,0.2903225806451610,0.2903225806451610
2007-09-29,2007,9,253,639,74,966,0.2619047619047620,0.2619047619047620
2007-09-30,2007,9,196,475,74,745,0.26308724832214800,0.26308724832214800
2007-10-01,2007,10,300,591,59,950,0.3157894736842110,0.3157894736842110
2007-10-02,2007,10,351,842,72,1265,0.2774703557312250,0.2774703557312250
2007-10-03,2007,10,509,964,89,1562,0.3258642765685020,0.3258642765685020
2007-10-04,2007,10,382,849,92,1323,0.2887377173091460,0.2887377173091460
2007-10-05,2007,10,391,903,82,1376,0.28415697674418600,0.28415697674418600
2007-10-06,2007,10,298,699,58,1055,0.2824644549763030,0.2824644549763030
2007-10-07,2007,10,188,519,45,752,0.25,0.25
2007-10-08,2007,10,162,446,49,657,0.2465753424657530,0.2465753424657530
2007-10-09,2007,10,338,830,94,1262,0.26782884310618100,0.26782884310618100
2007-10-10,2007,10,441,930,94,1465,0.30102389078498300,0.30102389078498300
2007-10-11,2007,10,452,827,79,1358,0.3328424153166420,0.3328424153166420
2007-10-12,2007,10,372,869,59,1300,0.28615384615384600,0.28615384615384600
2007-10-13,2007,10,308,758,52,1118,0.27549194991055500,0.27549194991055500
2007-10-14,2007,10,200,505,49,754,0.26525198938992000,0.26525198938992000
2007-10-15,2007,10,215,558,51,824,0.2609223300970870,0.2609223300970870
2007-10-16,2007,10,374,872,81,1327,0.28183873398643600,0.28183873398643600
2007-10-17,2007,10,501,964,77,1542,0.32490272373540900,0.32490272373540900
2007-10-18,2007,10,391,896,92,1379,0.28353879622915200,0.28353879622915200
2007-10-19,2007,10,339,756,76,1171,0.28949615713065800,0.28949615713065800
2007-10-20,2007,10,293,724,56,1073,0.27306616961789400,0.27306616961789400
2007-10-21,2007,10,224,562,40,826,0.2711864406779660,0.2711864406779660
2007-10-22,2007,10,225,545,48,818,0.27506112469437700,0.27506112469437700
2007-10-23,2007,10,380,961,81,1422,0.2672292545710270,0.2672292545710270
2007-10-24,2007,10,344,771,86,1201,0.28642797668609500,0.28642797668609500
2007-10-25,2007,10,337,926,82,1345,0.2505576208178440,0.2505576208178440
2007-10-26,2007,10,341,723,57,1121,0.30419268510258700,0.30419268510258700
2007-10-27,2007,10,280,629,41,950,0.29473684210526300,0.29473684210526300
2007-10-28,2007,10,180,462,41,683,0.2635431918008790,0.2635431918008790
2007-10-29,2007,10,192,490,38,720,0.26666666666666700,0.26666666666666700
2007-10-30,2007,10,265,760,60,1085,0.24423963133640600,0.24423963133640600
2007-10-31,2007,10,262,571,42,875,0.29942857142857100,0.29942857142857100
2007-11-01,2007,11,420,853,66,1339,0.31366691560866300,0.31366691560866300
2007-11-02,2007,11,346,901,56,1303,0.26554105909439800,0.26554105909439800
2007-11-03,2007,11,295,745,49,1089,0.27089072543618,0.27089072543618
2007-11-04,2007,11,159,513,36,708,0.2245762711864410,0.2245762711864410
2007-11-05,2007,11,226,495,52,773,0.2923673997412680,0.2923673997412680
2007-11-06,2007,11,292,635,46,973,0.3001027749229190,0.3001027749229190
2007-11-07,2007,11,383,879,71,1333,0.2873218304576140,0.2873218304576140
2007-11-08,2007,11,413,869,69,1351,0.30569948186528500,0.30569948186528500
2007-11-09,2007,11,268,873,62,1203,0.2227763923524520,0.2227763923524520
2007-11-10,2007,11,310,755,44,1109,0.2795311091073040,0.2795311091073040
2007-11-11,2007,11,173,517,35,725,0.2386206896551720,0.2386206896551720
2007-11-12,2007,11,227,558,47,832,0.27283653846153800,0.27283653846153800
2007-11-13,2007,11,381,859,81,1321,0.28841786525359600,0.28841786525359600
2007-11-14,2007,11,421,892,70,1383,0.30441070137382500,0.30441070137382500
2007-11-15,2007,11,407,826,64,1297,0.3138010794140320,0.3138010794140320
2007-11-16,2007,11,369,875,66,1310,0.2816793893129770,0.2816793893129770
2007-11-17,2007,11,244,766,39,1049,0.23260247855100100,0.23260247855100100
2007-11-18,2007,11,159,497,40,696,0.22844827586206900,0.22844827586206900
2007-11-19,2007,11,211,494,45,750,0.2813333333333330,0.2813333333333330
2007-11-20,2007,11,344,752,64,1160,0.296551724137931,0.296551724137931
2007-11-21,2007,11,243,650,47,940,0.25851063829787200,0.25851063829787200
2007-11-22,2007,11,73,177,20,270,0.27037037037037000,0.27037037037037000
2007-11-23,2007,11,271,691,41,1003,0.27018943170488500,0.27018943170488500
2007-11-24,2007,11,227,729,47,1003,0.226321036889332,0.226321036889332
2007-11-25,2007,11,163,454,46,663,0.2458521870286580,0.2458521870286580
2007-11-26,2007,11,228,438,27,693,0.329004329004329,0.329004329004329
2007-11-27,2007,11,342,881,64,1287,0.26573426573426600,0.26573426573426600
2007-11-28,2007,11,375,774,70,1219,0.30762920426579200,0.30762920426579200
2007-11-29,2007,11,393,792,67,1252,0.31389776357827500,0.31389776357827500
2007-11-30,2007,11,287,784,50,1121,0.256021409455843,0.256021409455843
2007-12-01,2007,12,273,713,40,1026,0.26608187134502900,0.26608187134502900
2007-12-02,2007,12,187,440,27,654,0.28593272171253800,0.28593272171253800
2007-12-03,2007,12,187,429,26,642,0.29127725856697800,0.29127725856697800
2007-12-04,2007,12,283,788,54,1125,0.25155555555555600,0.25155555555555600
2007-12-05,2007,12,378,855,62,1295,0.2918918918918920,0.2918918918918920
2007-12-06,2007,12,297,847,87,1231,0.2412672623883020,0.2412672623883020
2007-12-07,2007,12,377,851,68,1296,0.2908950617283950,0.2908950617283950
2007-12-08,2007,12,292,721,54,1067,0.2736644798500470,0.2736644798500470
2007-12-09,2007,12,139,489,35,663,0.2096530920060330,0.2096530920060330
2007-12-10,2007,12,204,485,44,733,0.2783083219645290,0.2783083219645290
2007-12-11,2007,12,290,803,63,1156,0.2508650519031140,0.2508650519031140
2007-12-12,2007,12,390,867,86,1343,0.2903946388682060,0.2903946388682060
2007-12-13,2007,12,225,505,52,782,0.2877237851662400,0.2877237851662400
2007-12-14,2007,12,330,811,48,1189,0.27754415475189200,0.27754415475189200
2007-12-15,2007,12,242,777,44,1063,0.22765757290686700,0.22765757290686700
2007-12-16,2007,12,108,366,27,501,0.2155688622754490,0.2155688622754490
2007-12-17,2007,12,167,418,29,614,0.2719869706840390,0.2719869706840390
2007-12-18,2007,12,318,757,65,1140,0.2789473684210530,0.2789473684210530
2007-12-19,2007,12,340,758,50,1148,0.2961672473867600,0.2961672473867600
2007-12-20,2007,12,339,753,56,1148,0.2952961672473870,0.2952961672473870
2007-12-21,2007,12,298,684,56,1038,0.28709055876685900,0.28709055876685900
2007-12-22,2007,12,191,550,40,781,0.24455825864276600,0.24455825864276600
2007-12-23,2007,12,120,441,23,584,0.2054794520547950,0.2054794520547950
2007-12-24,2007,12,105,209,12,326,0.3220858895705520,0.3220858895705520
2007-12-25,2007,12,81,126,7,214,0.37850467289719600,0.37850467289719600
2007-12-26,2007,12,201,628,34,863,0.23290845886442600,0.23290845886442600
2007-12-27,2007,12,280,766,38,1084,0.25830258302583000,0.25830258302583000
2007-12-28,2007,12,273,728,53,1054,0.25901328273244800,0.25901328273244800
2007-12-29,2007,12,177,632,36,845,0.20946745562130200,0.20946745562130200
2007-12-30,2007,12,154,364,22,540,0.2851851851851850,0.2851851851851850
2007-12-31,2007,12,84,244,17,345,0.24347826086956500,0.24347826086956500
2008-01-01,2008,1,207,515,40,762,0.27165354330708700,0.27165354330708700
2008-01-02,2008,1,303,836,72,1211,0.250206440957886,0.250206440957886
2008-01-03,2008,1,329,808,54,1191,0.2762384550797650,0.2762384550797650
2008-01-04,2008,1,401,988,55,1444,0.27770083102493100,0.27770083102493100
2008-01-05,2008,1,350,803,84,1237,0.28294260307194800,0.28294260307194800
2008-01-06,2008,1,192,486,35,713,0.26928471248246800,0.26928471248246800
2008-01-07,2008,1,236,546,56,838,0.28162291169451100,0.28162291169451100
2008-01-08,2008,1,427,1003,97,1527,0.2796332678454490,0.2796332678454490
2008-01-09,2008,1,335,1020,77,1432,0.23393854748603400,0.23393854748603400
2008-01-10,2008,1,398,1084,75,1557,0.2556197816313420,0.2556197816313420
2008-01-11,2008,1,474,1059,84,1617,0.29313543599257900,0.29313543599257900
2008-01-12,2008,1,324,936,71,1331,0.2434259954921110,0.2434259954921110
2008-01-13,2008,1,189,641,49,879,0.2150170648464160,0.2150170648464160
2008-01-14,2008,1,228,616,38,882,0.2585034013605440,0.2585034013605440
2008-01-15,2008,1,411,844,68,1323,0.31065759637188200,0.31065759637188200
2008-01-16,2008,1,441,938,57,1436,0.3071030640668520,0.3071030640668520
2008-01-17,2008,1,402,976,85,1463,0.2747778537252220,0.2747778537252220
2008-01-18,2008,1,424,1011,96,1531,0.2769431743958200,0.2769431743958200
2008-01-19,2008,1,251,914,77,1242,0.20209339774557200,0.20209339774557200
2008-01-20,2008,1,139,488,50,677,0.20531757754800600,0.20531757754800600
2008-01-21,2008,1,171,502,47,720,0.2375,0.2375
2008-01-22,2008,1,306,822,63,1191,0.25692695214105800,0.25692695214105800
2008-01-23,2008,1,351,836,61,1248,0.28125,0.28125
2008-01-24,2008,1,386,898,64,1348,0.28635014836795300,0.28635014836795300
2008-01-25,2008,1,352,843,70,1265,0.2782608695652170,0.2782608695652170
2008-01-26,2008,1,247,703,65,1015,0.24334975369458100,0.24334975369458100
2008-01-27,2008,1,166,589,53,808,0.20544554455445500,0.20544554455445500
2008-01-28,2008,1,221,565,53,839,0.2634088200238380,0.2634088200238380
2008-01-29,2008,1,362,820,70,1252,0.28913738019169300,0.28913738019169300
2008-01-30,2008,1,345,787,95,1227,0.28117359413202900,0.28117359413202900
2008-01-31,2008,1,350,839,76,1265,0.2766798418972330,0.2766798418972330
2008-02-01,2008,2,334,727,80,1141,0.2927256792287470,0.2927256792287470
2008-02-02,2008,2,354,880,64,1298,0.2727272727272730,0.2727272727272730
2008-02-03,2008,2,141,471,47,659,0.21396054628224600,0.21396054628224600
2008-02-04,2008,2,180,455,45,680,0.2647058823529410,0.2647058823529410
2008-02-05,2008,2,288,639,66,993,0.29003021148036300,0.29003021148036300
2008-02-06,2008,2,385,979,98,1462,0.26333789329685400,0.26333789329685400
2008-02-07,2008,2,413,967,91,1471,0.2807613868116930,0.2807613868116930
2008-02-08,2008,2,387,995,107,1489,0.25990597716588300,0.25990597716588300
2008-02-09,2008,2,311,871,75,1257,0.24741447891805900,0.24741447891805900
2008-02-10,2008,2,160,600,53,813,0.1968019680196800,0.1968019680196800
2008-02-11,2008,2,169,523,45,737,0.22930800542740800,0.22930800542740800
2008-02-12,2008,2,250,672,63,985,0.25380710659898500,0.25380710659898500
2008-02-13,2008,2,327,742,58,1127,0.290150842945874,0.290150842945874
2008-02-14,2008,2,294,780,72,1146,0.25654450261780100,0.25654450261780100
2008-02-15,2008,2,469,1034,102,1605,0.2922118380062310,0.2922118380062310
2008-02-16,2008,2,297,913,57,1267,0.23441199684293600,0.23441199684293600
2008-02-17,2008,2,151,552,57,760,0.1986842105263160,0.1986842105263160
2008-02-18,2008,2,224,536,50,810,0.2765432098765430,0.2765432098765430
2008-02-19,2008,2,388,914,52,1354,0.2865583456425410,0.2865583456425410
2008-02-20,2008,2,368,924,72,1364,0.2697947214076250,0.2697947214076250
2008-02-21,2008,2,373,915,62,1350,0.2762962962962960,0.2762962962962960
2008-02-22,2008,2,261,683,53,997,0.26178535606820500,0.26178535606820500
2008-02-23,2008,2,279,848,61,1188,0.23484848484848500,0.23484848484848500
2008-02-24,2008,2,175,535,53,763,0.22935779816513800,0.22935779816513800
2008-02-25,2008,2,229,559,65,853,0.268464243845252,0.268464243845252
2008-02-26,2008,2,321,832,73,1226,0.26182707993474700,0.26182707993474700
2008-02-27,2008,2,387,989,101,1477,0.26201760324983100,0.26201760324983100
2008-02-28,2008,2,309,876,78,1263,0.24465558194774300,0.24465558194774300
2008-02-29,2008,2,383,855,69,1307,0.2930374904361130,0.2930374904361130
2008-03-01,2008,3,276,774,67,1117,0.24709042076991900,0.24709042076991900
2008-03-02,2008,3,182,567,44,793,0.22950819672131100,0.22950819672131100
2008-03-03,2008,3,215,661,79,955,0.225130890052356,0.225130890052356
2008-03-04,2008,3,434,973,113,1520,0.2855263157894740,0.2855263157894740
2008-03-05,2008,3,471,1023,136,1630,0.2889570552147240,0.2889570552147240
2008-03-06,2008,3,400,1066,145,1611,0.2482929857231530,0.2482929857231530
2008-03-07,2008,3,384,958,148,1490,0.25771812080536900,0.25771812080536900
2008-03-08,2008,3,240,805,97,1142,0.21015761821366000,0.21015761821366000
2008-03-09,2008,3,129,474,58,661,0.1951588502269290,0.1951588502269290
2008-03-10,2008,3,204,564,64,832,0.24519230769230800,0.24519230769230800
2008-03-11,2008,3,391,929,88,1408,0.27769886363636400,0.27769886363636400
2008-03-12,2008,3,405,1060,104,1569,0.25812619502868100,0.25812619502868100
2008-03-13,2008,3,459,958,86,1503,0.30538922155688600,0.30538922155688600
2008-03-14,2008,3,298,802,89,1189,0.25063078216989100,0.25063078216989100
2008-03-15,2008,3,324,807,80,1211,0.2675474814203140,0.2675474814203140
2008-03-16,2008,3,159,532,60,751,0.21171770972037300,0.21171770972037300
2008-03-17,2008,3,190,497,61,748,0.2540106951871660,0.2540106951871660
2008-03-18,2008,3,333,926,71,1330,0.2503759398496240,0.2503759398496240
2008-03-19,2008,3,338,795,85,1218,0.277504105090312,0.277504105090312
2008-03-20,2008,3,384,911,82,1377,0.2788671023965140,0.2788671023965140
2008-03-21,2008,3,346,932,84,1362,0.2540381791483110,0.2540381791483110
2008-03-22,2008,3,272,811,61,1144,0.23776223776223800,0.23776223776223800
2008-03-23,2008,3,139,396,33,568,0.24471830985915500,0.24471830985915500
2008-03-24,2008,3,169,550,34,753,0.2244355909694560,0.2244355909694560
2008-03-25,2008,3,276,1010,61,1347,0.20489977728285100,0.20489977728285100
2008-03-26,2008,3,384,1015,96,1495,0.2568561872909700,0.2568561872909700
2008-03-27,2008,3,369,993,79,1441,0.25607217210270600,0.25607217210270600
2008-03-28,2008,3,347,921,82,1350,0.25703703703703700,0.25703703703703700
2008-03-29,2008,3,298,805,69,1172,0.25426621160409600,0.25426621160409600
2008-03-30,2008,3,139,506,41,686,0.20262390670553900,0.20262390670553900
2008-03-31,2008,3,196,542,62,800,0.245,0.245
2008-04-01,2008,4,374,803,81,1258,0.2972972972972970,0.2972972972972970
2008-04-02,2008,4,383,1084,100,1567,0.24441608168474800,0.24441608168474800
2008-04-03,2008,4,387,940,85,1412,0.27407932011331400,0.27407932011331400
2008-04-04,2008,4,364,869,89,1322,0.2753403933434190,0.2753403933434190
2008-04-05,2008,4,314,758,83,1155,0.27186147186147200,0.27186147186147200
2008-04-06,2008,4,169,599,44,812,0.20812807881773400,0.20812807881773400
2008-04-07,2008,4,245,562,45,852,0.2875586854460090,0.2875586854460090
2008-04-08,2008,4,366,856,81,1303,0.28089025326170400,0.28089025326170400
2008-04-09,2008,4,373,986,90,1449,0.25741890959282300,0.25741890959282300
2008-04-10,2008,4,365,983,88,1436,0.2541782729805010,0.2541782729805010
2008-04-11,2008,4,374,1006,91,1471,0.25424881033310700,0.25424881033310700
2008-04-12,2008,4,283,834,62,1179,0.24003392705682800,0.24003392705682800
2008-04-13,2008,4,141,596,53,790,0.17848101265822800,0.17848101265822800
2008-04-14,2008,4,258,644,55,957,0.26959247648902800,0.26959247648902800
2008-04-15,2008,4,379,912,65,1356,0.27949852507374600,0.27949852507374600
2008-04-16,2008,4,409,941,65,1415,0.2890459363957600,0.2890459363957600
2008-04-17,2008,4,365,770,86,1221,0.2989352989352990,0.2989352989352990
2008-04-18,2008,4,251,796,82,1129,0.22232063773250700,0.22232063773250700
2008-04-19,2008,4,205,618,70,893,0.22956326987682000,0.22956326987682000
2008-04-20,2008,4,154,477,54,685,0.22481751824817500,0.22481751824817500
2008-04-21,2008,4,223,481,48,752,0.29654255319148900,0.29654255319148900
2008-04-22,2008,4,313,797,55,1165,0.2686695278969960,0.2686695278969960
2008-04-23,2008,4,369,862,71,1302,0.2834101382488480,0.2834101382488480
2008-04-24,2008,4,324,805,67,1196,0.2709030100334450,0.2709030100334450
2008-04-25,2008,4,283,647,64,994,0.28470824949698200,0.28470824949698200
2008-04-26,2008,4,257,657,44,958,0.26826722338204600,0.26826722338204600
2008-04-27,2008,4,183,456,35,674,0.271513353115727,0.271513353115727
2008-04-28,2008,4,160,432,41,633,0.2527646129541860,0.2527646129541860
2008-04-29,2008,4,343,731,61,1135,0.3022026431718060,0.3022026431718060
2008-04-30,2008,4,303,851,59,1213,0.24979389942291800,0.24979389942291800
2008-05-01,2008,5,394,855,64,1313,0.3000761614623000,0.3000761614623000
2008-05-02,2008,5,350,848,66,1264,0.27689873417721500,0.27689873417721500
2008-05-03,2008,5,256,740,53,1049,0.2440419447092470,0.2440419447092470
2008-05-04,2008,5,171,494,62,727,0.23521320495185700,0.23521320495185700
2008-05-05,2008,5,225,518,42,785,0.28662420382165600,0.28662420382165600
2008-05-06,2008,5,379,948,52,1379,0.27483683828861500,0.27483683828861500
2008-05-07,2008,5,403,831,298,1532,0.2630548302872060,0.2630548302872060
2008-05-08,2008,5,362,952,95,1409,0.25691980127750200,0.25691980127750200
2008-05-09,2008,5,282,785,60,1127,0.2502218278615790,0.2502218278615790
2008-05-10,2008,5,234,718,69,1021,0.22918707149853100,0.22918707149853100
2008-05-11,2008,5,136,432,37,605,0.22479338842975200,0.22479338842975200
2008-05-12,2008,5,238,567,46,851,0.2796709753231490,0.2796709753231490
2008-05-13,2008,5,370,893,77,1340,0.27611940298507500,0.27611940298507500
2008-05-14,2008,5,412,955,58,1425,0.28912280701754400,0.28912280701754400
2008-05-15,2008,5,399,920,81,1400,0.285,0.285
2008-05-16,2008,5,350,742,53,1145,0.3056768558951970,0.3056768558951970
2008-05-17,2008,5,254,762,53,1069,0.23760523854069200,0.23760523854069200
2008-05-18,2008,5,190,473,42,705,0.2695035460992910,0.2695035460992910
2008-05-19,2008,5,233,564,47,844,0.27606635071090000,0.27606635071090000
2008-05-20,2008,5,305,740,54,1099,0.2775250227479530,0.2775250227479530
2008-05-21,2008,5,372,895,65,1332,0.27927927927927900,0.27927927927927900
2008-05-22,2008,5,340,875,74,1289,0.2637703646237390,0.2637703646237390
2008-05-23,2008,5,329,909,56,1294,0.2542503863987640,0.2542503863987640
2008-05-24,2008,5,273,688,61,1022,0.2671232876712330,0.2671232876712330
2008-05-25,2008,5,131,422,38,591,0.22165820642978000,0.22165820642978000
2008-05-26,2008,5,110,368,43,521,0.21113243761996200,0.21113243761996200
2008-05-27,2008,5,404,782,77,1263,0.31987331749802100,0.31987331749802100
2008-05-28,2008,5,390,966,85,1441,0.27064538514920200,0.27064538514920200
2008-05-29,2008,5,334,884,73,1291,0.2587141750580950,0.2587141750580950
2008-05-30,2008,5,324,788,90,1202,0.26955074875208000,0.26955074875208000
2008-05-31,2008,5,250,713,65,1028,0.24319066147859900,0.24319066147859900
2008-06-01,2008,6,172,442,51,665,0.2586466165413530,0.2586466165413530
2008-06-02,2008,6,258,553,102,913,0.28258488499452400,0.28258488499452400
2008-06-03,2008,6,348,1025,96,1469,0.23689584751531700,0.23689584751531700
2008-06-04,2008,6,385,1031,105,1521,0.25312294543063800,0.25312294543063800
2008-06-05,2008,6,379,974,136,1489,0.25453324378777700,0.25453324378777700
2008-06-06,2008,6,384,986,124,1494,0.2570281124497990,0.2570281124497990
2008-06-07,2008,6,242,701,72,1015,0.23842364532019700,0.23842364532019700
2008-06-08,2008,6,155,472,80,707,0.21923620933521900,0.21923620933521900
2008-06-09,2008,6,172,471,55,698,0.24641833810888300,0.24641833810888300
2008-06-10,2008,6,352,734,53,1139,0.3090430201931520,0.3090430201931520
2008-06-11,2008,6,431,874,75,1380,0.31231884057971000,0.31231884057971000
2008-06-12,2008,6,385,804,64,1253,0.30726256983240200,0.30726256983240200
2008-06-13,2008,6,427,865,92,1384,0.30852601156069400,0.30852601156069400
2008-06-14,2008,6,255,606,62,923,0.27627302275189600,0.27627302275189600
2008-06-15,2008,6,140,337,34,511,0.273972602739726,0.273972602739726
2008-06-16,2008,6,236,559,46,841,0.2806183115338880,0.2806183115338880
2008-06-17,2008,6,394,932,54,1380,0.2855072463768120,0.2855072463768120
2008-06-18,2008,6,399,929,105,1433,0.2784368457780880,0.2784368457780880
2008-06-19,2008,6,361,901,68,1330,0.2714285714285710,0.2714285714285710
2008-06-20,2008,6,433,949,69,1451,0.2984148862853210,0.2984148862853210
2008-06-21,2008,6,284,716,79,1079,0.2632066728452270,0.2632066728452270
2008-06-22,2008,6,158,431,57,646,0.24458204334365300,0.24458204334365300
2008-06-23,2008,6,237,546,37,820,0.2890243902439020,0.2890243902439020
2008-06-24,2008,6,392,939,67,1398,0.2804005722460660,0.2804005722460660
2008-06-25,2008,6,352,942,84,1378,0.25544267053701000,0.25544267053701000
2008-06-26,2008,6,341,892,91,1324,0.25755287009063400,0.25755287009063400
2008-06-27,2008,6,316,734,57,1107,0.28545618789521200,0.28545618789521200
2008-06-28,2008,6,219,565,64,848,0.25825471698113200,0.25825471698113200
2008-06-29,2008,6,153,394,33,580,0.2637931034482760,0.2637931034482760
2008-06-30,2008,6,164,478,33,675,0.24296296296296300,0.24296296296296300
2008-07-01,2008,7,334,876,62,1272,0.26257861635220100,0.26257861635220100
2008-07-02,2008,7,394,876,69,1339,0.29424943988050800,0.29424943988050800
2008-07-03,2008,7,341,759,61,1161,0.29371231696813100,0.29371231696813100
2008-07-04,2008,7,156,518,37,711,0.21940928270042200,0.21940928270042200
2008-07-05,2008,7,248,629,55,932,0.26609442060085800,0.26609442060085800
2008-07-06,2008,7,149,468,50,667,0.22338830584707600,0.22338830584707600
2008-07-07,2008,7,164,499,42,705,0.2326241134751770,0.2326241134751770
2008-07-08,2008,7,328,728,62,1118,0.29338103756708400,0.29338103756708400
2008-07-09,2008,7,370,792,69,1231,0.3005686433793660,0.3005686433793660
2008-07-10,2008,7,339,791,71,1201,0.28226477935054100,0.28226477935054100
2008-07-11,2008,7,337,830,85,1252,0.26916932907348200,0.26916932907348200
2008-07-12,2008,7,204,686,48,938,0.21748400852878500,0.21748400852878500
2008-07-13,2008,7,163,418,45,626,0.26038338658147000,0.26038338658147000
2008-07-14,2008,7,174,412,45,631,0.2757527733755940,0.2757527733755940
2008-07-15,2008,7,305,671,63,1039,0.29355149181905700,0.29355149181905700
2008-07-16,2008,7,371,877,74,1322,0.2806354009077160,0.2806354009077160
2008-07-17,2008,7,370,889,84,1343,0.2755026061057330,0.2755026061057330
2008-07-18,2008,7,353,766,66,1185,0.2978902953586500,0.2978902953586500
2008-07-19,2008,7,218,690,57,965,0.22590673575129500,0.22590673575129500
2008-07-20,2008,7,178,468,54,700,0.2542857142857140,0.2542857142857140
2008-07-21,2008,7,205,496,52,753,0.27224435590969500,0.27224435590969500
2008-07-22,2008,7,364,764,74,1202,0.30282861896838600,0.30282861896838600
2008-07-23,2008,7,434,890,74,1398,0.3104434907010010,0.3104434907010010
2008-07-24,2008,7,316,763,82,1161,0.2721791559000860,0.2721791559000860
2008-07-25,2008,7,304,773,80,1157,0.2627484874675890,0.2627484874675890
2008-07-26,2008,7,236,617,62,915,0.25792349726776000,0.25792349726776000
2008-07-27,2008,7,169,447,41,657,0.2572298325722980,0.2572298325722980
2008-07-28,2008,7,203,490,48,741,0.2739541160593790,0.2739541160593790
2008-07-29,2008,7,341,861,55,1257,0.27128082736674600,0.27128082736674600
2008-07-30,2008,7,416,872,101,1389,0.2994960403167750,0.2994960403167750
2008-07-31,2008,7,317,758,79,1154,0.27469670710571900,0.27469670710571900
2008-08-01,2008,8,379,778,68,1225,0.3093877551020410,0.3093877551020410
2008-08-02,2008,8,270,740,71,1081,0.24976873265494900,0.24976873265494900
2008-08-03,2008,8,183,484,62,729,0.25102880658436200,0.25102880658436200
2008-08-04,2008,8,228,552,41,821,0.2777101096224120,0.2777101096224120
2008-08-05,2008,8,329,799,77,1205,0.2730290456431540,0.2730290456431540
2008-08-06,2008,8,436,912,87,1435,0.30383275261324000,0.30383275261324000
2008-08-07,2008,8,340,851,83,1274,0.2668759811616960,0.2668759811616960
2008-08-08,2008,8,346,786,81,1213,0.2852431986809560,0.2852431986809560
2008-08-09,2008,8,272,669,65,1006,0.27037773359841000,0.27037773359841000
2008-08-10,2008,8,194,558,98,850,0.22823529411764700,0.22823529411764700
2008-08-11,2008,8,204,484,45,733,0.2783083219645290,0.2783083219645290
2008-08-12,2008,8,332,828,92,1252,0.26517571884984000,0.26517571884984000
2008-08-13,2008,8,407,906,90,1403,0.2900926585887380,0.2900926585887380
2008-08-14,2008,8,351,717,73,1141,0.30762489044697600,0.30762489044697600
2008-08-15,2008,8,301,835,70,1206,0.24958540630182400,0.24958540630182400
2008-08-16,2008,8,224,715,78,1017,0.22025565388397200,0.22025565388397200
2008-08-17,2008,8,142,437,64,643,0.2208398133748060,0.2208398133748060
2008-08-18,2008,8,199,500,64,763,0.2608125819134990,0.2608125819134990
2008-08-19,2008,8,321,745,77,1143,0.28083989501312300,0.28083989501312300
2008-08-20,2008,8,371,940,72,1383,0.26825741142444000,0.26825741142444000
2008-08-21,2008,8,299,881,74,1254,0.23843700159489600,0.23843700159489600
2008-08-22,2008,8,369,831,69,1269,0.2907801418439720,0.2907801418439720
2008-08-23,2008,8,231,640,59,930,0.24838709677419400,0.24838709677419400
2008-08-24,2008,8,150,466,47,663,0.22624434389140300,0.22624434389140300
2008-08-25,2008,8,203,442,55,700,0.29,0.29
2008-08-26,2008,8,297,817,67,1181,0.2514817950889080,0.2514817950889080
2008-08-27,2008,8,341,844,66,1251,0.27258193445243800,0.27258193445243800
2008-08-28,2008,8,319,793,74,1186,0.26897133220910600,0.26897133220910600
2008-08-29,2008,8,301,759,58,1118,0.2692307692307690,0.2692307692307690
2008-08-30,2008,8,254,661,60,975,0.2605128205128210,0.2605128205128210
2008-08-31,2008,8,139,419,42,600,0.23166666666666700,0.23166666666666700
2008-09-01,2008,9,146,380,32,558,0.2616487455197130,0.2616487455197130
2008-09-02,2008,9,285,679,72,1036,0.2750965250965250,0.2750965250965250
2008-09-03,2008,9,432,906,70,1408,0.3068181818181820,0.3068181818181820
2008-09-04,2008,9,340,720,76,1136,0.2992957746478870,0.2992957746478870
2008-09-05,2008,9,381,897,69,1347,0.2828507795100220,0.2828507795100220
2008-09-06,2008,9,226,539,43,808,0.27970297029703000,0.27970297029703000
2008-09-07,2008,9,153,510,53,716,0.21368715083798900,0.21368715083798900
2008-09-08,2008,9,235,488,56,779,0.30166880616174600,0.30166880616174600
2008-09-09,2008,9,303,567,78,948,0.31962025316455700,0.31962025316455700
2008-09-10,2008,9,426,974,78,1478,0.2882273342354530,0.2882273342354530
2008-09-11,2008,9,359,917,67,1343,0.2673119880863740,0.2673119880863740
2008-09-12,2008,9,336,831,87,1254,0.2679425837320570,0.2679425837320570
2008-09-13,2008,9,302,841,69,1212,0.24917491749174900,0.24917491749174900
2008-09-14,2008,9,215,560,58,833,0.2581032412965190,0.2581032412965190
2008-09-15,2008,9,258,538,43,839,0.3075089392133490,0.3075089392133490
2008-09-16,2008,9,373,898,86,1357,0.2748710390567430,0.2748710390567430
2008-09-17,2008,9,454,934,88,1476,0.3075880758807590,0.3075880758807590
2008-09-18,2008,9,433,920,89,1442,0.3002773925104020,0.3002773925104020
2008-09-19,2008,9,406,943,94,1443,0.28135828135828100,0.28135828135828100
2008-09-20,2008,9,276,783,71,1130,0.24424778761061900,0.24424778761061900
2008-09-21,2008,9,186,467,60,713,0.2608695652173910,0.2608695652173910
2008-09-22,2008,9,183,501,78,762,0.24015748031496100,0.24015748031496100
2008-09-23,2008,9,313,815,122,1250,0.2504,0.2504
2008-09-24,2008,9,298,815,136,1249,0.23859087269815900,0.23859087269815900
2008-09-25,2008,9,336,879,128,1343,0.2501861504095310,0.2501861504095310
2008-09-26,2008,9,251,744,105,1100,0.22818181818181800,0.22818181818181800
2008-09-27,2008,9,276,727,88,1091,0.2529789184234650,0.2529789184234650
2008-09-28,2008,9,211,456,61,728,0.28983516483516500,0.28983516483516500
2008-09-29,2008,9,223,516,48,787,0.2833545108005080,0.2833545108005080
2008-09-30,2008,9,330,790,59,1179,0.27989821882951700,0.27989821882951700
2008-10-01,2008,10,394,925,82,1401,0.28122769450392600,0.28122769450392600
2008-10-02,2008,10,395,891,129,1415,0.2791519434628980,0.2791519434628980
2008-10-03,2008,10,387,833,84,1304,0.2967791411042950,0.2967791411042950
2008-10-04,2008,10,252,762,71,1085,0.23225806451612900,0.23225806451612900
2008-10-05,2008,10,165,516,50,731,0.22571819425444600,0.22571819425444600
2008-10-06,2008,10,235,474,42,751,0.3129161118508660,0.3129161118508660
2008-10-07,2008,10,304,797,73,1174,0.25894378194207800,0.25894378194207800
2008-10-08,2008,10,345,1048,93,1486,0.23216689098250300,0.23216689098250300
2008-10-09,2008,10,403,994,98,1495,0.26956521739130400,0.26956521739130400
2008-10-10,2008,10,402,961,87,1450,0.2772413793103450,0.2772413793103450
2008-10-11,2008,10,294,811,72,1177,0.2497875955819880,0.2497875955819880
2008-10-12,2008,10,172,497,45,714,0.24089635854341700,0.24089635854341700
2008-10-13,2008,10,174,510,51,735,0.23673469387755100,0.23673469387755100
2008-10-14,2008,10,400,924,77,1401,0.28551034975017800,0.28551034975017800
2008-10-15,2008,10,460,980,81,1521,0.30243261012491800,0.30243261012491800
2008-10-16,2008,10,392,883,92,1367,0.2867593269934160,0.2867593269934160
2008-10-17,2008,10,420,909,69,1398,0.30042918454935600,0.30042918454935600
2008-10-18,2008,10,330,730,77,1137,0.29023746701847000,0.29023746701847000
2008-10-19,2008,10,149,500,42,691,0.21562952243125900,0.21562952243125900
2008-10-20,2008,10,220,587,42,849,0.2591283863368670,0.2591283863368670
2008-10-21,2008,10,353,906,71,1330,0.2654135338345870,0.2654135338345870
2008-10-22,2008,10,431,893,75,1399,0.3080771979985700,0.3080771979985700
2008-10-23,2008,10,359,913,88,1360,0.2639705882352940,0.2639705882352940
2008-10-24,2008,10,358,897,93,1348,0.2655786350148370,0.2655786350148370
2008-10-25,2008,10,327,697,61,1085,0.3013824884792630,0.3013824884792630
2008-10-26,2008,10,143,482,53,678,0.21091445427728600,0.21091445427728600
2008-10-27,2008,10,202,473,46,721,0.2801664355062410,0.2801664355062410
2008-10-28,2008,10,255,603,46,904,0.28207964601769900,0.28207964601769900
2008-10-29,2008,10,405,864,71,1340,0.30223880597014900,0.30223880597014900
2008-10-30,2008,10,355,782,70,1207,0.29411764705882400,0.29411764705882400
2008-10-31,2008,10,251,556,53,860,0.29186046511627900,0.29186046511627900
2008-11-01,2008,11,323,703,62,1088,0.296875,0.296875
2008-11-02,2008,11,169,459,34,662,0.2552870090634440,0.2552870090634440
2008-11-03,2008,11,221,486,41,748,0.29545454545454500,0.29545454545454500
2008-11-04,2008,11,225,614,59,898,0.2505567928730510,0.2505567928730510
2008-11-05,2008,11,383,822,65,1270,0.3015748031496060,0.3015748031496060
2008-11-06,2008,11,355,843,57,1255,0.28286852589641400,0.28286852589641400
2008-11-07,2008,11,433,989,88,1510,0.2867549668874170,0.2867549668874170
2008-11-08,2008,11,273,796,61,1130,0.2415929203539820,0.2415929203539820
2008-11-09,2008,11,172,550,49,771,0.2230869001297020,0.2230869001297020
2008-11-10,2008,11,222,532,43,797,0.27854454203262200,0.27854454203262200
2008-11-11,2008,11,351,890,66,1307,0.2685539403213470,0.2685539403213470
2008-11-12,2008,11,390,894,67,1351,0.28867505551443400,0.28867505551443400
2008-11-13,2008,11,274,657,76,1007,0.27209533267130100,0.27209533267130100
2008-11-14,2008,11,294,867,93,1254,0.23444976076555000,0.23444976076555000
2008-11-15,2008,11,256,785,58,1099,0.2329390354868060,0.2329390354868060
2008-11-16,2008,11,147,401,35,583,0.2521440823327620,0.2521440823327620
2008-11-17,2008,11,211,518,51,780,0.2705128205128210,0.2705128205128210
2008-11-18,2008,11,352,887,68,1307,0.26931905126243300,0.26931905126243300
2008-11-19,2008,11,400,868,79,1347,0.2969561989606530,0.2969561989606530
2008-11-20,2008,11,335,871,65,1271,0.26357199055861500,0.26357199055861500
2008-11-21,2008,11,374,1023,77,1474,0.2537313432835820,0.2537313432835820
2008-11-22,2008,11,246,785,65,1096,0.22445255474452600,0.22445255474452600
2008-11-23,2008,11,183,472,45,700,0.26142857142857100,0.26142857142857100
2008-11-24,2008,11,216,525,58,799,0.27033792240300400,0.27033792240300400
2008-11-25,2008,11,285,845,74,1204,0.2367109634551500,0.2367109634551500
2008-11-26,2008,11,233,663,80,976,0.2387295081967210,0.2387295081967210
2008-11-27,2008,11,86,184,21,291,0.29553264604811000,0.29553264604811000
2008-11-28,2008,11,243,752,54,1049,0.23164918970448000,0.23164918970448000
2008-11-29,2008,11,196,683,50,929,0.2109795479009690,0.2109795479009690
2008-11-30,2008,11,136,399,25,560,0.24285714285714300,0.24285714285714300
2008-12-01,2008,12,204,528,49,781,0.2612035851472470,0.2612035851472470
2008-12-02,2008,12,376,897,72,1345,0.2795539033457250,0.2795539033457250
2008-12-03,2008,12,307,922,89,1318,0.2329286798179060,0.2329286798179060
2008-12-04,2008,12,349,807,93,1249,0.27942353883106500,0.27942353883106500
2008-12-05,2008,12,319,898,77,1294,0.24652241112828400,0.24652241112828400
2008-12-06,2008,12,273,772,80,1125,0.24266666666666700,0.24266666666666700
2008-12-07,2008,12,153,431,30,614,0.249185667752443,0.249185667752443
2008-12-08,2008,12,165,511,48,724,0.22790055248618800,0.22790055248618800
2008-12-09,2008,12,346,924,70,1340,0.2582089552238810,0.2582089552238810
2008-12-10,2008,12,321,845,61,1227,0.2616136919315400,0.2616136919315400
2008-12-11,2008,12,313,681,54,1048,0.29866412213740500,0.29866412213740500
2008-12-12,2008,12,284,791,80,1155,0.24588744588744600,0.24588744588744600
2008-12-13,2008,12,238,808,55,1101,0.2161671207992730,0.2161671207992730
2008-12-14,2008,12,132,472,37,641,0.2059282371294850,0.2059282371294850
2008-12-15,2008,12,199,524,77,800,0.24875,0.24875
2008-12-16,2008,12,313,726,65,1104,0.28351449275362300,0.28351449275362300
2008-12-17,2008,12,374,813,71,1258,0.2972972972972970,0.2972972972972970
2008-12-18,2008,12,274,770,64,1108,0.24729241877256300,0.24729241877256300
2008-12-19,2008,12,161,590,56,807,0.19950433705080500,0.19950433705080500
2008-12-20,2008,12,177,618,55,850,0.20823529411764700,0.20823529411764700
2008-12-21,2008,12,126,388,21,535,0.23551401869158900,0.23551401869158900
2008-12-22,2008,12,127,434,26,587,0.21635434412265800,0.21635434412265800
2008-12-23,2008,12,210,648,25,883,0.23782559456398600,0.23782559456398600
2008-12-24,2008,12,99,215,12,326,0.30368098159509200,0.30368098159509200
2008-12-25,2008,12,73,139,3,215,0.3395348837209300,0.3395348837209300
2008-12-26,2008,12,263,660,42,965,0.27253886010362700,0.27253886010362700
2008-12-27,2008,12,213,737,58,1008,0.2113095238095240,0.2113095238095240
2008-12-28,2008,12,146,467,43,656,0.2225609756097560,0.2225609756097560
2008-12-29,2008,12,184,464,41,689,0.26705370101596500,0.26705370101596500
2008-12-30,2008,12,254,741,42,1037,0.24493731918997100,0.24493731918997100
2008-12-31,2008,12,125,346,27,498,0.25100401606425700,0.25100401606425700
2009-01-01,2009,1,223,509,30,762,0.2926509186351710,0.2926509186351710
2009-01-02,2009,1,302,887,81,1270,0.2377952755905510,0.2377952755905510
2009-01-03,2009,1,296,839,47,1182,0.25042301184433200,0.25042301184433200
2009-01-04,2009,1,148,531,47,726,0.20385674931129500,0.20385674931129500
2009-01-05,2009,1,218,509,37,764,0.28534031413612600,0.28534031413612600
2009-01-06,2009,1,355,854,87,1296,0.27391975308642000,0.27391975308642000
2009-01-07,2009,1,310,830,65,1205,0.2572614107883820,0.2572614107883820
2009-01-08,2009,1,416,1004,118,1538,0.270481144343303,0.270481144343303
2009-01-09,2009,1,405,1019,87,1511,0.2680344142951690,0.2680344142951690
2009-01-10,2009,1,248,682,55,985,0.2517766497461930,0.2517766497461930
2009-01-11,2009,1,145,479,39,663,0.2187028657616890,0.2187028657616890
2009-01-12,2009,1,206,647,94,947,0.21752903907075000,0.21752903907075000
2009-01-13,2009,1,415,1040,142,1597,0.2598622417031940,0.2598622417031940
2009-01-14,2009,1,409,1120,163,1692,0.241725768321513,0.241725768321513
2009-01-15,2009,1,349,937,132,1418,0.2461212976022570,0.2461212976022570
2009-01-16,2009,1,398,952,131,1481,0.2687373396353820,0.2687373396353820
2009-01-17,2009,1,292,825,103,1220,0.23934426229508200,0.23934426229508200
2009-01-18,2009,1,165,527,54,746,0.22117962466487900,0.22117962466487900
2009-01-19,2009,1,160,493,50,703,0.22759601706970100,0.22759601706970100
2009-01-20,2009,1,285,906,69,1260,0.2261904761904760,0.2261904761904760
2009-01-21,2009,1,412,982,71,1465,0.2812286689419800,0.2812286689419800
2009-01-22,2009,1,397,1022,101,1520,0.2611842105263160,0.2611842105263160
2009-01-23,2009,1,412,1040,109,1561,0.26393337604099900,0.26393337604099900
2009-01-24,2009,1,277,891,70,1238,0.22374798061389300,0.22374798061389300
2009-01-25,2009,1,119,504,63,686,0.17346938775510200,0.17346938775510200
2009-01-26,2009,1,259,632,47,938,0.27611940298507500,0.27611940298507500
2009-01-27,2009,1,321,905,82,1308,0.24541284403669700,0.24541284403669700
2009-01-28,2009,1,256,620,77,953,0.26862539349422900,0.26862539349422900
2009-01-29,2009,1,361,1012,107,1480,0.24391891891891900,0.24391891891891900
2009-01-30,2009,1,347,984,86,1417,0.24488355681016200,0.24488355681016200
2009-01-31,2009,1,249,812,77,1138,0.218804920913884,0.218804920913884
2009-02-01,2009,2,130,463,48,641,0.20280811232449300,0.20280811232449300
2009-02-02,2009,2,226,625,62,913,0.2475355969331870,0.2475355969331870
2009-02-03,2009,2,317,692,70,1079,0.293790546802595,0.293790546802595
2009-02-04,2009,2,395,929,91,1415,0.2791519434628980,0.2791519434628980
2009-02-05,2009,2,321,909,89,1319,0.24336618650492800,0.24336618650492800
2009-02-06,2009,2,313,957,116,1386,0.22582972582972600,0.22582972582972600
2009-02-07,2009,2,243,746,64,1053,0.23076923076923100,0.23076923076923100
2009-02-08,2009,2,142,602,62,806,0.1761786600496280,0.1761786600496280
2009-02-09,2009,2,222,619,83,924,0.24025974025974000,0.24025974025974000
2009-02-10,2009,2,402,996,111,1509,0.2664015904572570,0.2664015904572570
2009-02-11,2009,2,407,1174,140,1721,0.23649041255084300,0.23649041255084300
2009-02-12,2009,2,405,1182,108,1695,0.23893805309734500,0.23893805309734500
2009-02-13,2009,2,344,1021,104,1469,0.23417290673927800,0.23417290673927800
2009-02-14,2009,2,219,805,79,1103,0.1985494106980960,0.1985494106980960
2009-02-15,2009,2,191,569,55,815,0.2343558282208590,0.2343558282208590
2009-02-16,2009,2,157,693,55,905,0.1734806629834250,0.1734806629834250
2009-02-17,2009,2,313,960,80,1353,0.23133776792313400,0.23133776792313400
2009-02-18,2009,2,337,972,72,1381,0.2440260680666180,0.2440260680666180
2009-02-19,2009,2,295,945,93,1333,0.2213053263315830,0.2213053263315830
2009-02-20,2009,2,323,996,97,1416,0.22810734463276800,0.22810734463276800
2009-02-21,2009,2,251,999,82,1332,0.18843843843843800,0.18843843843843800
2009-02-22,2009,2,138,645,62,845,0.16331360946745600,0.16331360946745600
2009-02-23,2009,2,179,613,49,841,0.21284185493460200,0.21284185493460200
2009-02-24,2009,2,338,983,92,1413,0.23920736022646900,0.23920736022646900
2009-02-25,2009,2,387,1060,95,1542,0.2509727626459140,0.2509727626459140
2009-02-26,2009,2,338,1061,120,1519,0.22251481237656400,0.22251481237656400
2009-02-27,2009,2,397,1090,110,1597,0.2485911083281150,0.2485911083281150
2009-02-28,2009,2,283,901,85,1269,0.22301024428684000,0.22301024428684000
2009-03-01,2009,3,171,641,60,872,0.19610091743119300,0.19610091743119300
2009-03-02,2009,3,113,326,31,470,0.2404255319148940,0.2404255319148940
2009-03-03,2009,3,299,782,86,1167,0.25621251071122500,0.25621251071122500
2009-03-04,2009,3,360,1029,93,1482,0.242914979757085,0.242914979757085
2009-03-05,2009,3,381,1030,132,1543,0.24692158133506200,0.24692158133506200
2009-03-06,2009,3,377,1073,85,1535,0.24560260586319200,0.24560260586319200
2009-03-07,2009,3,334,1063,100,1497,0.22311289245157000,0.22311289245157000
2009-03-08,2009,3,150,584,87,821,0.18270401948842900,0.18270401948842900
2009-03-09,2009,3,239,624,62,925,0.2583783783783780,0.2583783783783780
2009-03-10,2009,3,354,1001,91,1446,0.24481327800829900,0.24481327800829900
2009-03-11,2009,3,394,1095,110,1599,0.24640400250156300,0.24640400250156300
2009-03-12,2009,3,402,979,87,1468,0.273841961852861,0.273841961852861
2009-03-13,2009,3,370,1039,85,1494,0.24765729585006700,0.24765729585006700
2009-03-14,2009,3,305,946,100,1351,0.22575869726128800,0.22575869726128800
2009-03-15,2009,3,158,620,76,854,0.18501170960187400,0.18501170960187400
2009-03-16,2009,3,214,631,56,901,0.23751387347391800,0.23751387347391800
2009-03-17,2009,3,264,858,96,1218,0.21674876847290600,0.21674876847290600
2009-03-18,2009,3,425,1002,125,1552,0.27384020618556700,0.27384020618556700
2009-03-19,2009,3,365,943,105,1413,0.25831564048124600,0.25831564048124600
2009-03-20,2009,3,328,1006,115,1449,0.2263630089717050,0.2263630089717050
2009-03-21,2009,3,287,870,104,1261,0.22759714512291800,0.22759714512291800
2009-03-22,2009,3,165,631,59,855,0.19298245614035100,0.19298245614035100
2009-03-23,2009,3,209,646,70,925,0.22594594594594600,0.22594594594594600
2009-03-24,2009,3,311,962,125,1398,0.2224606580829760,0.2224606580829760
2009-03-25,2009,3,379,1122,131,1632,0.23223039215686300,0.23223039215686300
2009-03-26,2009,3,346,896,99,1341,0.25801640566741200,0.25801640566741200
2009-03-27,2009,3,350,1025,101,1476,0.23712737127371300,0.23712737127371300
2009-03-28,2009,3,287,840,87,1214,0.23640856672158200,0.23640856672158200
2009-03-29,2009,3,151,532,65,748,0.2018716577540110,0.2018716577540110
2009-03-30,2009,3,231,597,62,890,0.2595505617977530,0.2595505617977530
2009-03-31,2009,3,317,855,89,1261,0.2513877874702620,0.2513877874702620
2009-04-01,2009,4,438,1001,96,1535,0.2853420195439740,0.2853420195439740
2009-04-02,2009,4,381,999,104,1484,0.25673854447439400,0.25673854447439400
2009-04-03,2009,4,380,900,89,1369,0.27757487216946700,0.27757487216946700
2009-04-04,2009,4,304,824,81,1209,0.25144747725392900,0.25144747725392900
2009-04-05,2009,4,141,524,55,720,0.19583333333333300,0.19583333333333300
2009-04-06,2009,4,176,515,68,759,0.2318840579710150,0.2318840579710150
2009-04-07,2009,4,310,919,81,1310,0.2366412213740460,0.2366412213740460
2009-04-08,2009,4,366,1025,104,1495,0.24481605351170600,0.24481605351170600
2009-04-09,2009,4,381,1036,105,1522,0.2503285151116950,0.2503285151116950
2009-04-10,2009,4,349,878,86,1313,0.26580350342726600,0.26580350342726600
2009-04-11,2009,4,258,756,67,1081,0.23866790009250700,0.23866790009250700
2009-04-12,2009,4,101,341,33,475,0.21263157894736800,0.21263157894736800
2009-04-13,2009,4,195,590,44,829,0.23522316043425800,0.23522316043425800
2009-04-14,2009,4,297,799,59,1155,0.2571428571428570,0.2571428571428570
2009-04-15,2009,4,281,1002,90,1373,0.2046613255644570,0.2046613255644570
2009-04-16,2009,4,300,955,93,1348,0.22255192878338300,0.22255192878338300
2009-04-17,2009,4,333,908,108,1349,0.2468495181616010,0.2468495181616010
2009-04-18,2009,4,236,769,73,1078,0.2189239332096480,0.2189239332096480
2009-04-19,2009,4,116,554,54,724,0.16022099447513800,0.16022099447513800
2009-04-20,2009,4,182,489,43,714,0.2549019607843140,0.2549019607843140
2009-04-21,2009,4,295,880,135,1310,0.22519083969465600,0.22519083969465600
2009-04-22,2009,4,410,1032,123,1565,0.26198083067092700,0.26198083067092700
2009-04-23,2009,4,327,980,109,1416,0.2309322033898310,0.2309322033898310
2009-04-24,2009,4,312,907,107,1326,0.23529411764705900,0.23529411764705900
2009-04-25,2009,4,266,733,97,1096,0.2427007299270070,0.2427007299270070
2009-04-26,2009,4,166,542,67,775,0.21419354838709700,0.21419354838709700
2009-04-27,2009,4,197,609,74,880,0.22386363636363600,0.22386363636363600
2009-04-28,2009,4,361,970,90,1421,0.25404644616467300,0.25404644616467300
2009-04-29,2009,4,427,986,92,1505,0.2837209302325580,0.2837209302325580
2009-04-30,2009,4,317,929,116,1362,0.2327459618208520,0.2327459618208520
2009-05-01,2009,5,375,914,90,1379,0.2719361856417690,0.2719361856417690
2009-05-02,2009,5,284,859,81,1224,0.23202614379085000,0.23202614379085000
2009-05-03,2009,5,163,534,69,766,0.21279373368146200,0.21279373368146200
2009-05-04,2009,5,183,529,33,745,0.24563758389261700,0.24563758389261700
2009-05-05,2009,5,303,898,88,1289,0.23506594259115600,0.23506594259115600
2009-05-06,2009,5,408,978,104,1490,0.2738255033557050,0.2738255033557050
2009-05-07,2009,5,342,924,116,1382,0.24746743849493500,0.24746743849493500
2009-05-08,2009,5,392,1065,116,1573,0.24920534011443100,0.24920534011443100
2009-05-09,2009,5,281,832,82,1195,0.23514644351464400,0.23514644351464400
2009-05-10,2009,5,119,466,76,661,0.1800302571860820,0.1800302571860820
2009-05-11,2009,5,211,701,126,1038,0.20327552986512500,0.20327552986512500
2009-05-12,2009,5,396,1057,171,1624,0.2438423645320200,0.2438423645320200
2009-05-13,2009,5,413,1169,165,1747,0.23640526617057800,0.23640526617057800
2009-05-14,2009,5,334,957,165,1456,0.22939560439560400,0.22939560439560400
2009-05-15,2009,5,381,1128,142,1651,0.23076923076923100,0.23076923076923100
2009-05-16,2009,5,318,783,121,1222,0.2602291325695580,0.2602291325695580
2009-05-17,2009,5,153,512,83,748,0.20454545454545500,0.20454545454545500
2009-05-18,2009,5,205,588,42,835,0.24550898203592800,0.24550898203592800
2009-05-19,2009,5,354,889,66,1309,0.27043544690603500,0.27043544690603500
2009-05-20,2009,5,404,1048,119,1571,0.25716104392106900,0.25716104392106900
2009-05-21,2009,5,357,970,106,1433,0.24912770411723700,0.24912770411723700
2009-05-22,2009,5,363,888,108,1359,0.2671081677704190,0.2671081677704190
2009-05-23,2009,5,247,760,94,1101,0.22434150772025400,0.22434150772025400
2009-05-24,2009,5,172,479,58,709,0.24259520451339900,0.24259520451339900
2009-05-25,2009,5,138,449,37,624,0.22115384615384600,0.22115384615384600
2009-05-26,2009,5,297,858,78,1233,0.24087591240875900,0.24087591240875900
2009-05-27,2009,5,305,976,81,1362,0.223935389133627,0.223935389133627
2009-05-28,2009,5,337,859,76,1272,0.264937106918239,0.264937106918239
2009-05-29,2009,5,320,934,86,1340,0.23880597014925400,0.23880597014925400
2009-05-30,2009,5,243,677,56,976,0.2489754098360660,0.2489754098360660
2009-05-31,2009,5,151,446,38,635,0.2377952755905510,0.2377952755905510
2009-06-01,2009,6,207,566,72,845,0.24497041420118300,0.24497041420118300
2009-06-02,2009,6,326,952,90,1368,0.23830409356725100,0.23830409356725100
2009-06-03,2009,6,334,973,90,1397,0.23908375089477500,0.23908375089477500
2009-06-04,2009,6,259,702,73,1034,0.2504835589941970,0.2504835589941970
2009-06-05,2009,6,321,838,93,1252,0.2563897763578280,0.2563897763578280
2009-06-06,2009,6,274,852,100,1226,0.2234910277324630,0.2234910277324630
2009-06-07,2009,6,186,492,55,733,0.25375170532060000,0.25375170532060000
2009-06-08,2009,6,247,594,54,895,0.2759776536312850,0.2759776536312850
2009-06-09,2009,6,356,883,79,1318,0.2701062215478000,0.2701062215478000
2009-06-10,2009,6,408,1069,101,1578,0.2585551330798480,0.2585551330798480
2009-06-11,2009,6,358,895,75,1328,0.26957831325301200,0.26957831325301200
2009-06-12,2009,6,284,980,84,1348,0.21068249258160200,0.21068249258160200
2009-06-13,2009,6,248,693,68,1009,0.24578790882061400,0.24578790882061400
2009-06-14,2009,6,190,556,106,852,0.22300469483568100,0.22300469483568100
2009-06-15,2009,6,217,550,58,825,0.263030303030303,0.263030303030303
2009-06-16,2009,6,377,968,100,1445,0.26089965397923900,0.26089965397923900
2009-06-17,2009,6,417,961,93,1471,0.28348062542488100,0.28348062542488100
2009-06-18,2009,6,329,736,64,1129,0.2914083259521700,0.2914083259521700
2009-06-19,2009,6,412,955,104,1471,0.28008157715839600,0.28008157715839600
2009-06-20,2009,6,272,766,87,1125,0.24177777777777800,0.24177777777777800
2009-06-21,2009,6,128,435,52,615,0.208130081300813,0.208130081300813
2009-06-22,2009,6,234,655,62,951,0.24605678233438500,0.24605678233438500
2009-06-23,2009,6,355,998,96,1449,0.24499654934437500,0.24499654934437500
2009-06-24,2009,6,339,899,93,1331,0.25469571750563500,0.25469571750563500
2009-06-25,2009,6,365,889,108,1362,0.26798825256975000,0.26798825256975000
2009-06-26,2009,6,322,875,115,1312,0.24542682926829300,0.24542682926829300
2009-06-27,2009,6,230,741,100,1071,0.21475256769374400,0.21475256769374400
2009-06-28,2009,6,145,564,67,776,0.18685567010309300,0.18685567010309300
2009-06-29,2009,6,197,555,59,811,0.24290998766954400,0.24290998766954400
2009-06-30,2009,6,265,813,87,1165,0.22746781115879800,0.22746781115879800
2009-07-01,2009,7,408,916,91,1415,0.28833922261484100,0.28833922261484100
2009-07-02,2009,7,311,914,82,1307,0.23794950267788800,0.23794950267788800
2009-07-03,2009,7,321,920,108,1349,0.2379540400296520,0.2379540400296520
2009-07-04,2009,7,174,604,68,846,0.20567375886524800,0.20567375886524800
2009-07-05,2009,7,184,551,69,804,0.22885572139303500,0.22885572139303500
2009-07-06,2009,7,200,505,55,760,0.2631578947368420,0.2631578947368420
2009-07-07,2009,7,287,859,84,1230,0.23333333333333300,0.23333333333333300
2009-07-08,2009,7,383,989,81,1453,0.26359256710254600,0.26359256710254600
2009-07-09,2009,7,340,995,112,1447,0.2349689011748450,0.2349689011748450
2009-07-10,2009,7,322,870,97,1289,0.24980605120248300,0.24980605120248300
2009-07-11,2009,7,248,767,74,1089,0.22773186409550000,0.22773186409550000
2009-07-12,2009,7,143,449,60,652,0.21932515337423300,0.21932515337423300
2009-07-13,2009,7,160,516,66,742,0.215633423180593,0.215633423180593
2009-07-14,2009,7,325,916,85,1326,0.24509803921568600,0.24509803921568600
2009-07-15,2009,7,387,989,88,1464,0.26434426229508200,0.26434426229508200
2009-07-16,2009,7,414,842,110,1366,0.30307467057101000,0.30307467057101000
2009-07-17,2009,7,361,846,88,1295,0.27876447876447900,0.27876447876447900
2009-07-18,2009,7,242,760,63,1065,0.2272300469483570,0.2272300469483570
2009-07-19,2009,7,145,537,63,745,0.19463087248322100,0.19463087248322100
2009-07-20,2009,7,191,566,66,823,0.23207776427703500,0.23207776427703500
2009-07-21,2009,7,283,756,84,1123,0.25200356188780100,0.25200356188780100
2009-07-22,2009,7,369,896,118,1383,0.2668112798264640,0.2668112798264640
2009-07-23,2009,7,317,797,79,1193,0.26571668063704900,0.26571668063704900
2009-07-24,2009,7,321,797,93,1211,0.26507018992568100,0.26507018992568100
2009-07-25,2009,7,225,684,97,1006,0.22365805168986100,0.22365805168986100
2009-07-26,2009,7,175,488,60,723,0.24204702627939100,0.24204702627939100
2009-07-27,2009,7,207,513,59,779,0.26572528883183600,0.26572528883183600
2009-07-28,2009,7,329,862,93,1284,0.2562305295950160,0.2562305295950160
2009-07-29,2009,7,308,831,97,1236,0.24919093851132700,0.24919093851132700
2009-07-30,2009,7,295,835,97,1227,0.2404237978810110,0.2404237978810110
2009-07-31,2009,7,270,740,71,1081,0.24976873265494900,0.24976873265494900
2009-08-01,2009,8,270,818,82,1170,0.23076923076923100,0.23076923076923100
2009-08-02,2009,8,154,514,55,723,0.21300138312586400,0.21300138312586400
2009-08-03,2009,8,197,579,56,832,0.23677884615384600,0.23677884615384600
2009-08-04,2009,8,340,842,88,1270,0.2677165354330710,0.2677165354330710
2009-08-05,2009,8,385,984,84,1453,0.2649690295939440,0.2649690295939440
2009-08-06,2009,8,379,912,103,1394,0.27187948350071700,0.27187948350071700
2009-08-07,2009,8,327,957,103,1387,0.2357606344628700,0.2357606344628700
2009-08-08,2009,8,284,772,81,1137,0.2497801231310470,0.2497801231310470
2009-08-09,2009,8,210,599,72,881,0.2383654937570940,0.2383654937570940
2009-08-10,2009,8,189,510,68,767,0.24641460234680600,0.24641460234680600
2009-08-11,2009,8,304,889,88,1281,0.2373145979703360,0.2373145979703360
2009-08-12,2009,8,366,1019,104,1489,0.2458025520483550,0.2458025520483550
2009-08-13,2009,8,381,991,94,1466,0.2598908594815830,0.2598908594815830
2009-08-14,2009,8,313,934,81,1328,0.23569277108433700,0.23569277108433700
2009-08-15,2009,8,283,798,80,1161,0.24375538329026700,0.24375538329026700
2009-08-16,2009,8,199,516,64,779,0.2554557124518610,0.2554557124518610
2009-08-17,2009,8,222,540,74,836,0.26555023923445000,0.26555023923445000
2009-08-18,2009,8,298,821,80,1199,0.24854045037531300,0.24854045037531300
2009-08-19,2009,8,355,998,85,1438,0.24687065368567500,0.24687065368567500
2009-08-20,2009,8,338,858,85,1281,0.26385636221701800,0.26385636221701800
2009-08-21,2009,8,346,851,91,1288,0.2686335403726710,0.2686335403726710
2009-08-22,2009,8,236,789,77,1102,0.21415607985480900,0.21415607985480900
2009-08-23,2009,8,167,531,55,753,0.22177954847277600,0.22177954847277600
2009-08-24,2009,8,173,531,72,776,0.22293814432989700,0.22293814432989700
2009-08-25,2009,8,267,889,101,1257,0.21241050119331700,0.21241050119331700
2009-08-26,2009,8,348,929,116,1393,0.2498205312275660,0.2498205312275660
2009-08-27,2009,8,359,1028,107,1494,0.24029451137884900,0.24029451137884900
2009-08-28,2009,8,292,785,89,1166,0.2504288164665520,0.2504288164665520
2009-08-29,2009,8,245,692,77,1014,0.2416173570019720,0.2416173570019720
2009-08-30,2009,8,145,534,71,750,0.19333333333333300,0.19333333333333300
2009-08-31,2009,8,209,496,56,761,0.27463863337713500,0.27463863337713500
2009-09-01,2009,9,308,884,76,1268,0.24290220820189300,0.24290220820189300
2009-09-02,2009,9,383,970,105,1458,0.2626886145404660,0.2626886145404660
2009-09-03,2009,9,327,924,88,1339,0.24421209858103100,0.24421209858103100
2009-09-04,2009,9,336,920,90,1346,0.24962852897474000,0.24962852897474000
2009-09-05,2009,9,320,833,83,1236,0.2588996763754050,0.2588996763754050
2009-09-06,2009,9,154,586,63,803,0.1917808219178080,0.1917808219178080
2009-09-07,2009,9,142,456,35,633,0.22432859399684000,0.22432859399684000
2009-09-08,2009,9,261,789,70,1120,0.2330357142857140,0.2330357142857140
2009-09-09,2009,9,342,904,71,1317,0.25968109339407700,0.25968109339407700
2009-09-10,2009,9,349,846,102,1297,0.2690824980724750,0.2690824980724750
2009-09-11,2009,9,287,694,67,1048,0.2738549618320610,0.2738549618320610
2009-09-12,2009,9,249,773,87,1109,0.22452660054102800,0.22452660054102800
2009-09-13,2009,9,187,550,64,801,0.23345817727840200,0.23345817727840200
2009-09-14,2009,9,156,557,64,777,0.20077220077220100,0.20077220077220100
2009-09-15,2009,9,247,684,92,1023,0.24144672531769300,0.24144672531769300
2009-09-16,2009,9,383,977,106,1466,0.26125511596180100,0.26125511596180100
2009-09-17,2009,9,405,965,161,1531,0.2645329849771390,0.2645329849771390
2009-09-18,2009,9,391,1001,113,1505,0.25980066445182700,0.25980066445182700
2009-09-19,2009,9,226,839,107,1172,0.19283276450511900,0.19283276450511900
2009-09-20,2009,9,174,499,70,743,0.23418573351278600,0.23418573351278600
2009-09-21,2009,9,180,568,101,849,0.21201413427561800,0.21201413427561800
2009-09-22,2009,9,299,910,130,1339,0.22330097087378600,0.22330097087378600
2009-09-23,2009,9,388,920,121,1429,0.271518544436669,0.271518544436669
2009-09-24,2009,9,287,891,109,1287,0.222999222999223,0.222999222999223
2009-09-25,2009,9,255,884,94,1233,0.20681265206812700,0.20681265206812700
2009-09-26,2009,9,188,726,73,987,0.19047619047619000,0.19047619047619000
2009-09-27,2009,9,134,514,48,696,0.1925287356321840,0.1925287356321840
2009-09-28,2009,9,156,462,64,682,0.2287390029325510,0.2287390029325510
2009-09-29,2009,9,213,642,78,933,0.2282958199356910,0.2282958199356910
2009-09-30,2009,9,272,883,99,1254,0.21690590111642700,0.21690590111642700
2009-10-01,2009,10,346,1074,92,1512,0.22883597883597900,0.22883597883597900
2009-10-02,2009,10,324,988,93,1405,0.23060498220640600,0.23060498220640600
2009-10-03,2009,10,262,868,84,1214,0.2158154859967050,0.2158154859967050
2009-10-04,2009,10,210,587,55,852,0.24647887323943700,0.24647887323943700
2009-10-05,2009,10,191,565,79,835,0.22874251497006000,0.22874251497006000
2009-10-06,2009,10,397,1009,86,1492,0.2660857908847190,0.2660857908847190
2009-10-07,2009,10,367,1040,101,1508,0.24336870026525200,0.24336870026525200
2009-10-08,2009,10,318,1075,101,1494,0.21285140562249000,0.21285140562249000
2009-10-09,2009,10,361,962,86,1409,0.25621007806955300,0.25621007806955300
2009-10-10,2009,10,234,844,70,1148,0.2038327526132400,0.2038327526132400
2009-10-11,2009,10,172,688,65,925,0.18594594594594600,0.18594594594594600
2009-10-12,2009,10,161,556,54,771,0.20881971465629100,0.20881971465629100
2009-10-13,2009,10,356,985,68,1409,0.2526614620298080,0.2526614620298080
2009-10-14,2009,10,331,1013,78,1422,0.23277074542897300,0.23277074542897300
2009-10-15,2009,10,298,713,65,1076,0.27695167286245400,0.27695167286245400
2009-10-16,2009,10,348,881,69,1298,0.26810477657935300,0.26810477657935300
2009-10-17,2009,10,263,849,74,1186,0.22175379426644200,0.22175379426644200
2009-10-18,2009,10,169,431,33,633,0.2669826224328590,0.2669826224328590
2009-10-19,2009,10,177,568,56,801,0.2209737827715360,0.2209737827715360
2009-10-20,2009,10,302,763,86,1151,0.26238053866203300,0.26238053866203300
2009-10-21,2009,10,385,1091,86,1562,0.24647887323943700,0.24647887323943700
2009-10-22,2009,10,378,956,89,1423,0.2656359803232610,0.2656359803232610
2009-10-23,2009,10,341,966,103,1410,0.24184397163120600,0.24184397163120600
2009-10-24,2009,10,232,631,61,924,0.2510822510822510,0.2510822510822510
2009-10-25,2009,10,171,511,48,730,0.23424657534246600,0.23424657534246600
2009-10-26,2009,10,195,588,52,835,0.23353293413173700,0.23353293413173700
2009-10-27,2009,10,284,832,71,1187,0.2392586352148270,0.2392586352148270
2009-10-28,2009,10,284,745,69,1098,0.2586520947176690,0.2586520947176690
2009-10-29,2009,10,332,717,87,1136,0.29225352112676100,0.29225352112676100
2009-10-30,2009,10,307,894,81,1282,0.23946957878315100,0.23946957878315100
2009-10-31,2009,10,228,612,56,896,0.2544642857142860,0.2544642857142860
2009-11-01,2009,11,140,552,44,736,0.19021739130434800,0.19021739130434800
2009-11-02,2009,11,187,505,56,748,0.25,0.25
2009-11-03,2009,11,249,709,79,1037,0.24011571841851500,0.24011571841851500
2009-11-04,2009,11,330,859,85,1274,0.25902668759811600,0.25902668759811600
2009-11-05,2009,11,327,886,71,1284,0.2546728971962620,0.2546728971962620
2009-11-06,2009,11,321,920,66,1307,0.24560061208875300,0.24560061208875300
2009-11-07,2009,11,275,896,69,1240,0.2217741935483870,0.2217741935483870
2009-11-08,2009,11,241,578,54,873,0.27605956471935900,0.27605956471935900
2009-11-09,2009,11,202,587,65,854,0.23653395784543300,0.23653395784543300
2009-11-10,2009,11,367,973,77,1417,0.2589978828510940,0.2589978828510940
2009-11-11,2009,11,357,1020,71,1448,0.24654696132596700,0.24654696132596700
2009-11-12,2009,11,325,876,76,1277,0.2545027407987470,0.2545027407987470
2009-11-13,2009,11,361,989,89,1439,0.250868658790827,0.250868658790827
2009-11-14,2009,11,237,766,64,1067,0.22211808809747000,0.22211808809747000
2009-11-15,2009,11,189,493,56,738,0.25609756097561000,0.25609756097561000
2009-11-16,2009,11,212,638,43,893,0.2374020156774920,0.2374020156774920
2009-11-17,2009,11,356,1040,90,1486,0.2395693135935400,0.2395693135935400
2009-11-18,2009,11,386,979,94,1459,0.26456477039067900,0.26456477039067900
2009-11-19,2009,11,341,984,80,1405,0.24270462633452000,0.24270462633452000
2009-11-20,2009,11,371,1109,102,1582,0.2345132743362830,0.2345132743362830
2009-11-21,2009,11,287,915,71,1273,0.22545168892380200,0.22545168892380200
2009-11-22,2009,11,137,534,74,745,0.18389261744966400,0.18389261744966400
2009-11-23,2009,11,204,623,53,880,0.2318181818181820,0.2318181818181820
2009-11-24,2009,11,326,959,75,1360,0.23970588235294100,0.23970588235294100
2009-11-25,2009,11,249,700,60,1009,0.24677898909811700,0.24677898909811700
2009-11-26,2009,11,78,232,18,328,0.23780487804878000,0.23780487804878000
2009-11-27,2009,11,226,833,50,1109,0.2037871956717760,0.2037871956717760
2009-11-28,2009,11,226,749,63,1038,0.21772639691714800,0.21772639691714800
2009-11-29,2009,11,146,512,57,715,0.2041958041958040,0.2041958041958040
2009-11-30,2009,11,145,458,58,661,0.21936459909228400,0.21936459909228400
2009-12-01,2009,12,380,911,79,1370,0.2773722627737230,0.2773722627737230
2009-12-02,2009,12,356,993,94,1443,0.2467082467082470,0.2467082467082470
2009-12-03,2009,12,368,915,94,1377,0.2672476397966590,0.2672476397966590
2009-12-04,2009,12,353,1015,97,1465,0.24095563139931700,0.24095563139931700
2009-12-05,2009,12,229,733,53,1015,0.22561576354679800,0.22561576354679800
2009-12-06,2009,12,138,490,46,674,0.20474777448071200,0.20474777448071200
2009-12-07,2009,12,214,545,40,799,0.26783479349186500,0.26783479349186500
2009-12-08,2009,12,348,978,84,1410,0.24680851063829800,0.24680851063829800
2009-12-09,2009,12,317,877,87,1281,0.24746291959406700,0.24746291959406700
2009-12-10,2009,12,298,836,79,1213,0.24567188788128600,0.24567188788128600
2009-12-11,2009,12,247,829,58,1134,0.21781305114638400,0.21781305114638400
2009-12-12,2009,12,239,824,65,1128,0.21187943262411300,0.21187943262411300
2009-12-13,2009,12,140,457,39,636,0.22012578616352200,0.22012578616352200
2009-12-14,2009,12,209,543,64,816,0.25612745098039200,0.25612745098039200
2009-12-15,2009,12,298,867,59,1224,0.2434640522875820,0.2434640522875820
2009-12-16,2009,12,351,920,81,1352,0.25961538461538500,0.25961538461538500
2009-12-17,2009,12,235,758,75,1068,0.2200374531835210,0.2200374531835210
2009-12-18,2009,12,239,881,58,1178,0.2028862478777590,0.2028862478777590
2009-12-19,2009,12,143,485,43,671,0.21311475409836100,0.21311475409836100
2009-12-20,2009,12,70,286,22,378,0.18518518518518500,0.18518518518518500
2009-12-21,2009,12,176,433,34,643,0.2737169517884910,0.2737169517884910
2009-12-22,2009,12,298,770,67,1135,0.26255506607929500,0.26255506607929500
2009-12-23,2009,12,236,668,55,959,0.24608967674661100,0.24608967674661100
2009-12-24,2009,12,69,248,13,330,0.20909090909090900,0.20909090909090900
2009-12-25,2009,12,59,125,9,193,0.30569948186528500,0.30569948186528500
2009-12-26,2009,12,101,464,19,584,0.17294520547945200,0.17294520547945200
2009-12-27,2009,12,134,482,27,643,0.208398133748056,0.208398133748056
2009-12-28,2009,12,189,464,42,695,0.2719424460431660,0.2719424460431660
2009-12-29,2009,12,210,763,49,1022,0.2054794520547950,0.2054794520547950
2009-12-30,2009,12,266,816,55,1137,0.2339489885664030,0.2339489885664030
2009-12-31,2009,12,99,359,34,492,0.20121951219512200,0.20121951219512200
2010-01-01,2010,1,251,650,49,950,0.26421052631578900,0.26421052631578900
2010-01-02,2010,1,222,715,29,966,0.22981366459627300,0.22981366459627300
2010-01-03,2010,1,118,483,33,634,0.1861198738170350,0.1861198738170350
2010-01-04,2010,1,176,519,34,729,0.24142661179698200,0.24142661179698200
2010-01-05,2010,1,291,910,73,1274,0.22841444270015700,0.22841444270015700
2010-01-06,2010,1,370,978,69,1417,0.2611150317572340,0.2611150317572340
2010-01-07,2010,1,402,1075,107,1584,0.2537878787878790,0.2537878787878790
2010-01-08,2010,1,367,1020,81,1468,0.25,0.25
2010-01-09,2010,1,258,884,62,1204,0.21428571428571400,0.21428571428571400
2010-01-10,2010,1,156,535,36,727,0.21458046767537800,0.21458046767537800
2010-01-11,2010,1,214,618,62,894,0.23937360178970900,0.23937360178970900
2010-01-12,2010,1,289,977,64,1330,0.21729323308270700,0.21729323308270700
2010-01-13,2010,1,372,1088,90,1550,0.24,0.24
2010-01-14,2010,1,422,1011,108,1541,0.2738481505515900,0.2738481505515900
2010-01-15,2010,1,397,1136,94,1627,0.24400737553780000,0.24400737553780000
2010-01-16,2010,1,272,995,81,1348,0.20178041543026700,0.20178041543026700
2010-01-17,2010,1,163,499,37,699,0.23319027181688100,0.23319027181688100
2010-01-18,2010,1,188,652,112,952,0.19747899159663900,0.19747899159663900
2010-01-19,2010,1,360,1086,145,1591,0.2262727844123190,0.2262727844123190
2010-01-20,2010,1,427,1157,182,1766,0.24178935447338600,0.24178935447338600
2010-01-21,2010,1,360,1139,154,1653,0.2177858439201450,0.2177858439201450
2010-01-22,2010,1,425,1118,148,1691,0.25133057362507400,0.25133057362507400
2010-01-23,2010,1,277,928,105,1310,0.21145038167938900,0.21145038167938900
2010-01-24,2010,1,148,603,74,825,0.17939393939393900,0.17939393939393900
2010-01-25,2010,1,143,469,36,648,0.22067901234567900,0.22067901234567900
2010-01-26,2010,1,334,890,82,1306,0.2557427258805510,0.2557427258805510
2010-01-27,2010,1,380,970,87,1437,0.26443980514961700,0.26443980514961700
2010-01-28,2010,1,288,841,83,1212,0.2376237623762380,0.2376237623762380
2010-01-29,2010,1,339,841,72,1252,0.2707667731629390,0.2707667731629390
2010-01-30,2010,1,218,663,53,934,0.2334047109207710,0.2334047109207710
2010-01-31,2010,1,108,500,38,646,0.16718266253870000,0.16718266253870000
2010-02-01,2010,2,191,585,57,833,0.22929171668667500,0.22929171668667500
2010-02-02,2010,2,336,983,78,1397,0.24051539012168900,0.24051539012168900
2010-02-03,2010,2,330,993,99,1422,0.2320675105485230,0.2320675105485230
2010-02-04,2010,2,405,1042,93,1540,0.262987012987013,0.262987012987013
2010-02-05,2010,2,391,1032,85,1508,0.2592838196286470,0.2592838196286470
2010-02-06,2010,2,268,837,71,1176,0.22789115646258500,0.22789115646258500
2010-02-07,2010,2,113,438,43,594,0.19023569023569000,0.19023569023569000
2010-02-08,2010,2,205,559,53,817,0.25091799265605900,0.25091799265605900
2010-02-09,2010,2,382,981,91,1454,0.2627235213204950,0.2627235213204950
2010-02-10,2010,2,118,339,41,498,0.23694779116465900,0.23694779116465900
2010-02-11,2010,2,268,875,84,1227,0.21841890790546000,0.21841890790546000
2010-02-12,2010,2,389,1070,97,1556,0.25,0.25
2010-02-13,2010,2,265,889,67,1221,0.21703521703521700,0.21703521703521700
2010-02-14,2010,2,127,473,42,642,0.19781931464174500,0.19781931464174500
2010-02-15,2010,2,158,584,48,790,0.2,0.2
2010-02-16,2010,2,244,678,65,987,0.24721377912867300,0.24721377912867300
2010-02-17,2010,2,318,995,81,1394,0.22812051649928300,0.22812051649928300
2010-02-18,2010,2,361,1124,83,1568,0.2302295918367350,0.2302295918367350
2010-02-19,2010,2,326,1000,99,1425,0.2287719298245610,0.2287719298245610
2010-02-20,2010,2,272,982,72,1326,0.20512820512820500,0.20512820512820500
2010-02-21,2010,2,157,596,54,807,0.19454770755886000,0.19454770755886000
2010-02-22,2010,2,190,671,61,922,0.20607375271149700,0.20607375271149700
2010-02-23,2010,2,281,762,74,1117,0.25156669650850500,0.25156669650850500
2010-02-24,2010,2,405,1091,102,1598,0.25344180225281600,0.25344180225281600
2010-02-25,2010,2,270,692,70,1032,0.2616279069767440,0.2616279069767440
2010-02-26,2010,2,196,472,48,716,0.2737430167597770,0.2737430167597770
2010-02-27,2010,2,263,840,60,1163,0.22613929492691300,0.22613929492691300
2010-02-28,2010,2,130,544,56,730,0.1780821917808220,0.1780821917808220
2010-03-01,2010,3,190,689,90,969,0.19607843137254900,0.19607843137254900
2010-03-02,2010,3,336,1073,117,1526,0.22018348623853200,0.22018348623853200
2010-03-03,2010,3,422,1109,122,1653,0.25529340592861500,0.25529340592861500
2010-03-04,2010,3,386,1122,134,1642,0.2350791717417780,0.2350791717417780
2010-03-05,2010,3,355,1175,155,1685,0.21068249258160200,0.21068249258160200
2010-03-06,2010,3,239,1048,97,1384,0.1726878612716760,0.1726878612716760
2010-03-07,2010,3,177,660,71,908,0.1949339207048460,0.1949339207048460
2010-03-08,2010,3,207,691,53,951,0.21766561514195600,0.21766561514195600
2010-03-09,2010,3,300,977,80,1357,0.2210759027266030,0.2210759027266030
2010-03-10,2010,3,392,1045,98,1535,0.2553745928338760,0.2553745928338760
2010-03-11,2010,3,365,1102,90,1557,0.23442517662170800,0.23442517662170800
2010-03-12,2010,3,351,964,84,1399,0.25089349535382400,0.25089349535382400
2010-03-13,2010,3,148,662,53,863,0.17149478563151800,0.17149478563151800
2010-03-14,2010,3,138,477,39,654,0.21100917431192700,0.21100917431192700
2010-03-15,2010,3,187,547,42,776,0.24097938144329900,0.24097938144329900
2010-03-16,2010,3,393,959,88,1440,0.27291666666666700,0.27291666666666700
2010-03-17,2010,3,328,938,86,1352,0.24260355029585800,0.24260355029585800
2010-03-18,2010,3,372,1047,91,1510,0.24635761589404000,0.24635761589404000
2010-03-19,2010,3,357,1064,100,1521,0.23471400394477300,0.23471400394477300
2010-03-20,2010,3,235,766,55,1056,0.22253787878787900,0.22253787878787900
2010-03-21,2010,3,161,620,52,833,0.19327731092437000,0.19327731092437000
2010-03-22,2010,3,175,549,36,760,0.23026315789473700,0.23026315789473700
2010-03-23,2010,3,307,954,62,1323,0.23204837490551800,0.23204837490551800
2010-03-24,2010,3,327,1072,99,1498,0.21829105473965300,0.21829105473965300
2010-03-25,2010,3,380,1074,85,1539,0.24691358024691400,0.24691358024691400
2010-03-26,2010,3,320,881,77,1278,0.25039123630672900,0.25039123630672900
2010-03-27,2010,3,253,806,68,1127,0.22448979591836700,0.22448979591836700
2010-03-28,2010,3,169,521,47,737,0.22930800542740800,0.22930800542740800
2010-03-29,2010,3,124,454,38,616,0.2012987012987010,0.2012987012987010
2010-03-30,2010,3,201,619,60,880,0.22840909090909100,0.22840909090909100
2010-03-31,2010,3,288,864,65,1217,0.23664749383730500,0.23664749383730500
2010-04-01,2010,4,330,1074,89,1493,0.22103148024112500,0.22103148024112500
2010-04-02,2010,4,309,941,91,1341,0.23042505592841200,0.23042505592841200
2010-04-03,2010,4,255,792,80,1127,0.22626441881100300,0.22626441881100300
2010-04-04,2010,4,141,382,52,575,0.24521739130434800,0.24521739130434800
2010-04-05,2010,4,198,560,46,804,0.2462686567164180,0.2462686567164180
2010-04-06,2010,4,316,964,110,1390,0.2273381294964030,0.2273381294964030
2010-04-07,2010,4,371,1104,127,1602,0.23158551810237200,0.23158551810237200
2010-04-08,2010,4,375,1052,106,1533,0.2446183953033270,0.2446183953033270
2010-04-09,2010,4,314,1016,98,1428,0.21988795518207300,0.21988795518207300
2010-04-10,2010,4,246,805,48,1099,0.22383985441310300,0.22383985441310300
2010-04-11,2010,4,142,572,65,779,0.1822849807445440,0.1822849807445440
2010-04-12,2010,4,238,622,69,929,0.25618945102260500,0.25618945102260500
2010-04-13,2010,4,319,966,87,1372,0.2325072886297380,0.2325072886297380
2010-04-14,2010,4,363,1071,128,1562,0.2323943661971830,0.2323943661971830
2010-04-15,2010,4,335,1005,115,1455,0.23024054982817900,0.23024054982817900
2010-04-16,2010,4,356,950,107,1413,0.2519462137296530,0.2519462137296530
2010-04-17,2010,4,253,944,70,1267,0.19968429360694600,0.19968429360694600
2010-04-18,2010,4,165,566,57,788,0.20939086294416200,0.20939086294416200
2010-04-19,2010,4,194,609,62,865,0.22427745664739900,0.22427745664739900
2010-04-20,2010,4,413,1047,156,1616,0.2555693069306930,0.2555693069306930
2010-04-21,2010,4,443,1017,140,1600,0.276875,0.276875
2010-04-22,2010,4,425,962,146,1533,0.27723418134377000,0.27723418134377000
2010-04-23,2010,4,390,1045,151,1586,0.2459016393442620,0.2459016393442620
2010-04-24,2010,4,297,845,101,1243,0.23893805309734500,0.23893805309734500
2010-04-25,2010,4,126,566,46,738,0.17073170731707300,0.17073170731707300
2010-04-26,2010,4,188,481,52,721,0.260748959778086,0.260748959778086
2010-04-27,2010,4,336,956,90,1382,0.24312590448625200,0.24312590448625200
2010-04-28,2010,4,389,1064,97,1550,0.2509677419354840,0.2509677419354840
2010-04-29,2010,4,329,1016,90,1435,0.22926829268292700,0.22926829268292700
2010-04-30,2010,4,313,936,111,1360,0.2301470588235290,0.2301470588235290
2010-05-01,2010,5,242,902,91,1235,0.19595141700404900,0.19595141700404900
2010-05-02,2010,5,156,541,73,770,0.2025974025974030,0.2025974025974030
2010-05-03,2010,5,193,492,67,752,0.2566489361702130,0.2566489361702130
2010-05-04,2010,5,318,934,99,1351,0.23538119911176900,0.23538119911176900
2010-05-05,2010,5,380,1094,121,1595,0.23824451410658300,0.23824451410658300
2010-05-06,2010,5,355,1035,141,1531,0.2318745917700850,0.2318745917700850
2010-05-07,2010,5,344,1101,129,1574,0.21855146124523500,0.21855146124523500
2010-05-08,2010,5,272,886,74,1232,0.22077922077922100,0.22077922077922100
2010-05-09,2010,5,115,487,38,640,0.1796875,0.1796875
2010-05-10,2010,5,237,640,67,944,0.2510593220338980,0.2510593220338980
2010-05-11,2010,5,316,967,98,1381,0.22881969587255600,0.22881969587255600
2010-05-12,2010,5,380,954,89,1423,0.2670414617006330,0.2670414617006330
2010-05-13,2010,5,367,1105,143,1615,0.22724458204334400,0.22724458204334400
2010-05-14,2010,5,364,997,128,1489,0.24445936870382800,0.24445936870382800
2010-05-15,2010,5,240,827,98,1165,0.20600858369098700,0.20600858369098700
2010-05-16,2010,5,155,562,63,780,0.1987179487179490,0.1987179487179490
2010-05-17,2010,5,215,650,60,925,0.23243243243243200,0.23243243243243200
2010-05-18,2010,5,294,728,79,1101,0.2670299727520440,0.2670299727520440
2010-05-19,2010,5,401,1009,113,1523,0.26329612606697300,0.26329612606697300
2010-05-20,2010,5,434,1151,128,1713,0.2533566841798020,0.2533566841798020
2010-05-21,2010,5,338,1036,124,1498,0.22563417890520700,0.22563417890520700
2010-05-22,2010,5,266,897,93,1256,0.21178343949044600,0.21178343949044600
2010-05-23,2010,5,179,516,41,736,0.24320652173913000,0.24320652173913000
2010-05-24,2010,5,254,679,75,1008,0.251984126984127,0.251984126984127
2010-05-25,2010,5,345,1005,82,1432,0.2409217877094970,0.2409217877094970
2010-05-26,2010,5,381,962,100,1443,0.26403326403326400,0.26403326403326400
2010-05-27,2010,5,351,917,101,1369,0.25639152666179700,0.25639152666179700
2010-05-28,2010,5,318,916,100,1334,0.2383808095952020,0.2383808095952020
2010-05-29,2010,5,212,841,82,1135,0.186784140969163,0.186784140969163
2010-05-30,2010,5,131,515,66,712,0.18398876404494400,0.18398876404494400
2010-05-31,2010,5,109,381,48,538,0.20260223048327100,0.20260223048327100
2010-06-01,2010,6,303,867,67,1237,0.24494745351657200,0.24494745351657200
2010-06-02,2010,6,364,1099,81,1544,0.23575129533678800,0.23575129533678800
2010-06-03,2010,6,391,981,95,1467,0.2665303340149970,0.2665303340149970
2010-06-04,2010,6,335,1091,99,1525,0.21967213114754100,0.21967213114754100
2010-06-05,2010,6,238,880,72,1190,0.2,0.2
2010-06-06,2010,6,144,520,57,721,0.19972260748959800,0.19972260748959800
2010-06-07,2010,6,202,622,50,874,0.2311212814645310,0.2311212814645310
2010-06-08,2010,6,364,1049,105,1518,0.23978919631093500,0.23978919631093500
2010-06-09,2010,6,272,921,73,1266,0.21484992101105800,0.21484992101105800
2010-06-10,2010,6,322,1006,100,1428,0.22549019607843100,0.22549019607843100
2010-06-11,2010,6,323,1062,102,1487,0.2172158708809680,0.2172158708809680
2010-06-12,2010,6,228,822,95,1145,0.19912663755458500,0.19912663755458500
2010-06-13,2010,6,182,574,90,846,0.21513002364066200,0.21513002364066200
2010-06-14,2010,6,270,554,55,879,0.30716723549488100,0.30716723549488100
2010-06-15,2010,6,316,940,101,1357,0.2328666175386880,0.2328666175386880
2010-06-16,2010,6,373,1082,104,1559,0.23925593329057100,0.23925593329057100
2010-06-17,2010,6,341,981,88,1410,0.24184397163120600,0.24184397163120600
2010-06-18,2010,6,307,1055,107,1469,0.2089857045609260,0.2089857045609260
2010-06-19,2010,6,198,833,91,1122,0.17647058823529400,0.17647058823529400
2010-06-20,2010,6,93,360,87,540,0.17222222222222200,0.17222222222222200
2010-06-21,2010,6,161,579,47,787,0.204574332909784,0.204574332909784
2010-06-22,2010,6,280,897,71,1248,0.22435897435897400,0.22435897435897400
2010-06-23,2010,6,397,1041,106,1544,0.25712435233160600,0.25712435233160600
2010-06-24,2010,6,363,872,93,1328,0.2733433734939760,0.2733433734939760
2010-06-25,2010,6,324,909,89,1322,0.24508320726172500,0.24508320726172500
2010-06-26,2010,6,230,776,74,1080,0.21296296296296300,0.21296296296296300
2010-06-27,2010,6,166,493,54,713,0.23281907433380100,0.23281907433380100
2010-06-28,2010,6,212,505,52,769,0.2756827048114430,0.2756827048114430
2010-06-29,2010,6,314,824,92,1230,0.2552845528455290,0.2552845528455290
2010-06-30,2010,6,272,832,86,1190,0.22857142857142900,0.22857142857142900
2010-07-01,2010,7,373,989,96,1458,0.2558299039780520,0.2558299039780520
2010-07-02,2010,7,224,802,63,1089,0.2056932966023880,0.2056932966023880
2010-07-03,2010,7,203,721,84,1008,0.2013888888888890,0.2013888888888890
2010-07-04,2010,7,144,474,52,670,0.21492537313432800,0.21492537313432800
2010-07-05,2010,7,179,505,63,747,0.23962516733601100,0.23962516733601100
2010-07-06,2010,7,310,767,75,1152,0.2690972222222220,0.2690972222222220
2010-07-07,2010,7,348,961,76,1385,0.2512635379061370,0.2512635379061370
2010-07-08,2010,7,321,989,93,1403,0.22879543834640100,0.22879543834640100
2010-07-09,2010,7,295,944,89,1328,0.22213855421686700,0.22213855421686700
2010-07-10,2010,7,298,815,84,1197,0.24895572263993300,0.24895572263993300
2010-07-11,2010,7,143,537,74,754,0.1896551724137930,0.1896551724137930
2010-07-12,2010,7,185,561,70,816,0.2267156862745100,0.2267156862745100
2010-07-13,2010,7,314,859,84,1257,0.2498011137629280,0.2498011137629280
2010-07-14,2010,7,394,908,95,1397,0.28203292770221900,0.28203292770221900
2010-07-15,2010,7,311,989,113,1413,0.22009907997169100,0.22009907997169100
2010-07-16,2010,7,337,966,110,1413,0.23849964614295800,0.23849964614295800
2010-07-17,2010,7,245,786,93,1124,0.2179715302491100,0.2179715302491100
2010-07-18,2010,7,163,559,59,781,0.2087067861715750,0.2087067861715750
2010-07-19,2010,7,201,528,57,786,0.25572519083969500,0.25572519083969500
2010-07-20,2010,7,309,895,82,1286,0.24027993779160200,0.24027993779160200
2010-07-21,2010,7,365,970,113,1448,0.2520718232044200,0.2520718232044200
2010-07-22,2010,7,332,910,103,1345,0.24684014869888500,0.24684014869888500
2010-07-23,2010,7,277,811,95,1183,0.23415046491969600,0.23415046491969600
2010-07-24,2010,7,230,668,93,991,0.23208879919273500,0.23208879919273500
2010-07-25,2010,7,159,565,68,792,0.20075757575757600,0.20075757575757600
2010-07-26,2010,7,153,504,42,699,0.21888412017167400,0.21888412017167400
2010-07-27,2010,7,339,832,85,1256,0.26990445859872600,0.26990445859872600
2010-07-28,2010,7,327,718,95,1140,0.2868421052631580,0.2868421052631580
2010-07-29,2010,7,350,916,106,1372,0.25510204081632700,0.25510204081632700
2010-07-30,2010,7,277,853,89,1219,0.22723543888433100,0.22723543888433100
2010-07-31,2010,7,229,719,84,1032,0.22189922480620200,0.22189922480620200
2010-08-01,2010,8,194,554,75,823,0.23572296476306200,0.23572296476306200
2010-08-02,2010,8,184,565,58,807,0.22800495662949200,0.22800495662949200
2010-08-03,2010,8,362,883,74,1319,0.2744503411675510,0.2744503411675510
2010-08-04,2010,8,379,978,110,1467,0.25835037491479200,0.25835037491479200
2010-08-05,2010,8,292,931,105,1328,0.21987951807228900,0.21987951807228900
2010-08-06,2010,8,329,930,88,1347,0.24424647364513700,0.24424647364513700
2010-08-07,2010,8,221,812,103,1136,0.19454225352112700,0.19454225352112700
2010-08-08,2010,8,197,606,65,868,0.2269585253456220,0.2269585253456220
2010-08-09,2010,8,188,549,46,783,0.24010217113665400,0.24010217113665400
2010-08-10,2010,8,311,859,81,1251,0.24860111910471600,0.24860111910471600
2010-08-11,2010,8,386,1045,94,1525,0.25311475409836100,0.25311475409836100
2010-08-12,2010,8,308,893,90,1291,0.238574748257165,0.238574748257165
2010-08-13,2010,8,340,972,92,1404,0.24216524216524200,0.24216524216524200
2010-08-14,2010,8,254,859,106,1219,0.20836751435603000,0.20836751435603000
2010-08-15,2010,8,134,550,66,750,0.17866666666666700,0.17866666666666700
2010-08-16,2010,8,168,578,61,807,0.20817843866171000,0.20817843866171000
2010-08-17,2010,8,339,887,74,1300,0.26076923076923100,0.26076923076923100
2010-08-18,2010,8,387,1040,86,1513,0.255783212161269,0.255783212161269
2010-08-19,2010,8,328,883,99,1310,0.250381679389313,0.250381679389313
2010-08-20,2010,8,355,937,115,1407,0.2523098791755510,0.2523098791755510
2010-08-21,2010,8,210,777,101,1088,0.19301470588235300,0.19301470588235300
2010-08-22,2010,8,143,495,66,704,0.203125,0.203125
2010-08-23,2010,8,157,469,56,682,0.23020527859237500,0.23020527859237500
2010-08-24,2010,8,297,845,67,1209,0.2456575682382130,0.2456575682382130
2010-08-25,2010,8,358,893,96,1347,0.2657757980697850,0.2657757980697850
2010-08-26,2010,8,333,921,88,1342,0.2481371087928470,0.2481371087928470
2010-08-27,2010,8,305,890,108,1303,0.2340752110514200,0.2340752110514200
2010-08-28,2010,8,214,803,100,1117,0.19158460161145900,0.19158460161145900
2010-08-29,2010,8,159,587,71,817,0.19461444308445500,0.19461444308445500
2010-08-30,2010,8,166,569,51,786,0.21119592875318100,0.21119592875318100
2010-08-31,2010,8,258,733,82,1073,0.24044734389562000,0.24044734389562000
2010-09-01,2010,9,353,963,99,1415,0.24946996466431100,0.24946996466431100
2010-09-02,2010,9,325,912,129,1366,0.23792093704246000,0.23792093704246000
2010-09-03,2010,9,338,911,93,1342,0.2518628912071540,0.2518628912071540
2010-09-04,2010,9,274,843,109,1226,0.2234910277324630,0.2234910277324630
2010-09-05,2010,9,154,584,58,796,0.1934673366834170,0.1934673366834170
2010-09-06,2010,9,130,451,45,626,0.20766773162939300,0.20766773162939300
2010-09-07,2010,9,277,822,67,1166,0.23756432246998300,0.23756432246998300
2010-09-08,2010,9,291,1063,110,1464,0.1987704918032790,0.1987704918032790
2010-09-09,2010,9,318,953,104,1375,0.23127272727272700,0.23127272727272700
2010-09-10,2010,9,341,944,110,1395,0.24444444444444400,0.24444444444444400
2010-09-11,2010,9,223,801,69,1093,0.2040256175663310,0.2040256175663310
2010-09-12,2010,9,130,519,47,696,0.1867816091954020,0.1867816091954020
2010-09-13,2010,9,159,519,54,732,0.21721311475409800,0.21721311475409800
2010-09-14,2010,9,262,631,77,970,0.27010309278350500,0.27010309278350500
2010-09-15,2010,9,367,1110,99,1576,0.23286802030456900,0.23286802030456900
2010-09-16,2010,9,382,759,88,1229,0.31082180634662300,0.31082180634662300
2010-09-17,2010,9,286,866,114,1266,0.2259083728278040,0.2259083728278040
2010-09-18,2010,9,273,831,101,1205,0.22655601659751000,0.22655601659751000
2010-09-19,2010,9,148,571,48,767,0.19295958279009100,0.19295958279009100
2010-09-20,2010,9,194,514,74,782,0.24808184143222500,0.24808184143222500
2010-09-21,2010,9,264,938,101,1303,0.20260936300844200,0.20260936300844200
2010-09-22,2010,9,299,852,131,1282,0.23322932917316700,0.23322932917316700
2010-09-23,2010,9,257,880,120,1257,0.20445505171042200,0.20445505171042200
2010-09-24,2010,9,296,842,147,1285,0.23035019455252900,0.23035019455252900
2010-09-25,2010,9,242,772,89,1103,0.21940163191296500,0.21940163191296500
2010-09-26,2010,9,169,564,77,810,0.20864197530864200,0.20864197530864200
2010-09-27,2010,9,166,471,45,682,0.2434017595307920,0.2434017595307920
2010-09-28,2010,9,274,810,80,1164,0.23539518900343600,0.23539518900343600
2010-09-29,2010,9,322,1020,103,1445,0.22283737024221500,0.22283737024221500
2010-09-30,2010,9,281,750,68,1099,0.2556869881710650,0.2556869881710650
2010-10-01,2010,10,300,911,91,1302,0.2304147465437790,0.2304147465437790
2010-10-02,2010,10,282,973,95,1350,0.2088888888888890,0.2088888888888890
2010-10-03,2010,10,176,536,64,776,0.2268041237113400,0.2268041237113400
2010-10-04,2010,10,207,522,56,785,0.26369426751592400,0.26369426751592400
2010-10-05,2010,10,354,963,69,1386,0.2554112554112550,0.2554112554112550
2010-10-06,2010,10,438,1067,108,1613,0.27154370737755700,0.27154370737755700
2010-10-07,2010,10,327,982,121,1430,0.22867132867132900,0.22867132867132900
2010-10-08,2010,10,395,1023,120,1538,0.25682704811443400,0.25682704811443400
2010-10-09,2010,10,266,898,88,1252,0.2124600638977640,0.2124600638977640
2010-10-10,2010,10,164,582,72,818,0.20048899755501200,0.20048899755501200
2010-10-11,2010,10,159,559,63,781,0.20358514724711900,0.20358514724711900
2010-10-12,2010,10,319,946,89,1354,0.23559822747415100,0.23559822747415100
2010-10-13,2010,10,422,1020,123,1565,0.26964856230031900,0.26964856230031900
2010-10-14,2010,10,331,957,67,1355,0.24428044280442800,0.24428044280442800
2010-10-15,2010,10,322,955,97,1374,0.23435225618631700,0.23435225618631700
2010-10-16,2010,10,255,904,84,1243,0.20514883346741800,0.20514883346741800
2010-10-17,2010,10,199,568,59,826,0.24092009685230000,0.24092009685230000
2010-10-18,2010,10,214,549,49,812,0.26354679802955700,0.26354679802955700
2010-10-19,2010,10,307,942,93,1342,0.22876304023845000,0.22876304023845000
2010-10-20,2010,10,385,1047,100,1532,0.25130548302872100,0.25130548302872100
2010-10-21,2010,10,334,1032,114,1480,0.22567567567567600,0.22567567567567600
2010-10-22,2010,10,359,1021,91,1471,0.24405166553365100,0.24405166553365100
2010-10-23,2010,10,249,903,81,1233,0.20194647201946500,0.20194647201946500
2010-10-24,2010,10,170,554,68,792,0.21464646464646500,0.21464646464646500
2010-10-25,2010,10,190,586,74,850,0.2235294117647060,0.2235294117647060
2010-10-26,2010,10,348,922,87,1357,0.25644804716285900,0.25644804716285900
2010-10-27,2010,10,352,843,103,1298,0.2711864406779660,0.2711864406779660
2010-10-28,2010,10,323,991,107,1421,0.22730471498944400,0.22730471498944400
2010-10-29,2010,10,300,959,98,1357,0.2210759027266030,0.2210759027266030
2010-10-30,2010,10,202,743,102,1047,0.1929321872015280,0.1929321872015280
2010-10-31,2010,10,137,472,58,667,0.20539730134932500,0.20539730134932500
2010-11-01,2010,11,159,525,51,735,0.2163265306122450,0.2163265306122450
2010-11-02,2010,11,257,664,74,995,0.25829145728643200,0.25829145728643200
2010-11-03,2010,11,353,1044,109,1506,0.23439575033200500,0.23439575033200500
2010-11-04,2010,11,295,805,86,1186,0.2487352445193930,0.2487352445193930
2010-11-05,2010,11,362,974,122,1458,0.24828532235939600,0.24828532235939600
2010-11-06,2010,11,281,961,98,1340,0.20970149253731300,0.20970149253731300
2010-11-07,2010,11,141,500,46,687,0.2052401746724890,0.2052401746724890
2010-11-08,2010,11,194,484,64,742,0.261455525606469,0.261455525606469
2010-11-09,2010,11,291,902,85,1278,0.22769953051643200,0.22769953051643200
2010-11-10,2010,11,374,1003,102,1479,0.25287356321839100,0.25287356321839100
2010-11-11,2010,11,312,1036,79,1427,0.21864050455501100,0.21864050455501100
2010-11-12,2010,11,330,1020,102,1452,0.22727272727272700,0.22727272727272700
2010-11-13,2010,11,282,964,97,1343,0.2099776619508560,0.2099776619508560
2010-11-14,2010,11,159,557,58,774,0.2054263565891470,0.2054263565891470
2010-11-15,2010,11,170,557,64,791,0.21491782553729500,0.21491782553729500
2010-11-16,2010,11,301,819,73,1193,0.25230511316010100,0.25230511316010100
2010-11-17,2010,11,317,994,91,1402,0.2261055634807420,0.2261055634807420
2010-11-18,2010,11,380,1088,105,1573,0.24157660521296900,0.24157660521296900
2010-11-19,2010,11,377,1045,114,1536,0.24544270833333300,0.24544270833333300
2010-11-20,2010,11,205,932,57,1194,0.17169179229480700,0.17169179229480700
2010-11-21,2010,11,163,585,57,805,0.20248447204968900,0.20248447204968900
2010-11-22,2010,11,197,581,56,834,0.23621103117506000,0.23621103117506000
2010-11-23,2010,11,355,900,93,1348,0.263353115727003,0.263353115727003
2010-11-24,2010,11,228,721,89,1038,0.21965317919075100,0.21965317919075100
2010-11-25,2010,11,73,194,11,278,0.26258992805755400,0.26258992805755400
2010-11-26,2010,11,223,788,64,1075,0.20744186046511600,0.20744186046511600
2010-11-27,2010,11,187,797,70,1054,0.1774193548387100,0.1774193548387100
2010-11-28,2010,11,153,550,55,758,0.20184696569920800,0.20184696569920800
2010-11-29,2010,11,187,533,71,791,0.23640960809102400,0.23640960809102400
2010-11-30,2010,11,257,682,86,1025,0.25073170731707300,0.25073170731707300
2010-12-01,2010,12,288,791,68,1147,0.25108979947689600,0.25108979947689600
2010-12-02,2010,12,355,932,89,1376,0.25799418604651200,0.25799418604651200
2010-12-03,2010,12,257,974,83,1314,0.19558599695586000,0.19558599695586000
2010-12-04,2010,12,249,863,79,1191,0.20906801007556700,0.20906801007556700
2010-12-05,2010,12,161,545,45,751,0.21438082556591200,0.21438082556591200
2010-12-06,2010,12,169,490,64,723,0.23374827109266900,0.23374827109266900
2010-12-07,2010,12,309,871,88,1268,0.24369085173501600,0.24369085173501600
2010-12-08,2010,12,374,999,90,1463,0.2556390977443610,0.2556390977443610
2010-12-09,2010,12,264,780,83,1127,0.23425022182786200,0.23425022182786200
2010-12-10,2010,12,272,963,77,1312,0.2073170731707320,0.2073170731707320
2010-12-11,2010,12,243,826,60,1129,0.21523472099202800,0.21523472099202800
2010-12-12,2010,12,113,466,41,620,0.18225806451612900,0.18225806451612900
2010-12-13,2010,12,189,533,57,779,0.24261874197689300,0.24261874197689300
2010-12-14,2010,12,214,803,64,1081,0.19796484736355200,0.19796484736355200
2010-12-15,2010,12,275,848,79,1202,0.22878535773710500,0.22878535773710500
2010-12-16,2010,12,238,718,80,1036,0.22972972972973000,0.22972972972973000
2010-12-17,2010,12,274,952,91,1317,0.20804859529233100,0.20804859529233100
2010-12-18,2010,12,245,858,57,1160,0.21120689655172400,0.21120689655172400
2010-12-19,2010,12,117,536,36,689,0.16981132075471700,0.16981132075471700
2010-12-20,2010,12,205,545,45,795,0.2578616352201260,0.2578616352201260
2010-12-21,2010,12,277,864,67,1208,0.2293046357615890,0.2293046357615890
2010-12-22,2010,12,277,875,76,1228,0.2255700325732900,0.2255700325732900
2010-12-23,2010,12,193,674,48,915,0.21092896174863400,0.21092896174863400
2010-12-24,2010,12,80,259,14,353,0.22662889518413600,0.22662889518413600
2010-12-25,2010,12,42,126,2,170,0.24705882352941200,0.24705882352941200
2010-12-26,2010,12,39,174,10,223,0.17488789237668200,0.17488789237668200
2010-12-27,2010,12,23,63,5,91,0.25274725274725300,0.25274725274725300
2010-12-28,2010,12,75,293,19,387,0.1937984496124030,0.1937984496124030
2010-12-29,2010,12,142,553,45,740,0.1918918918918920,0.1918918918918920
2010-12-30,2010,12,227,490,56,773,0.2936610608020700,0.2936610608020700
2010-12-31,2010,12,110,358,26,494,0.22267206477732800,0.22267206477732800
2011-01-01,2011,1,248,609,40,897,0.27647714604236300,0.27647714604236300
2011-01-02,2011,1,74,377,34,485,0.15257731958762900,0.15257731958762900
2011-01-03,2011,1,166,493,36,695,0.23884892086330900,0.23884892086330900
2011-01-04,2011,1,308,983,66,1357,0.22697126013264600,0.22697126013264600
2011-01-05,2011,1,373,1069,97,1539,0.24236517218973400,0.24236517218973400
2011-01-06,2011,1,322,1071,87,1480,0.21756756756756800,0.21756756756756800
2011-01-07,2011,1,324,934,71,1329,0.24379232505643300,0.24379232505643300
2011-01-08,2011,1,220,805,54,1079,0.20389249304912000,0.20389249304912000
2011-01-09,2011,1,163,531,31,725,0.22482758620689700,0.22482758620689700
2011-01-10,2011,1,198,559,43,800,0.2475,0.2475
2011-01-11,2011,1,313,869,70,1252,0.25,0.25
2011-01-12,2011,1,197,638,77,912,0.21600877192982500,0.21600877192982500
2011-01-13,2011,1,358,1106,87,1551,0.2308188265635070,0.2308188265635070
2011-01-14,2011,1,348,1020,95,1463,0.23786739576213300,0.23786739576213300
2011-01-15,2011,1,250,917,86,1253,0.19952114924182000,0.19952114924182000
2011-01-16,2011,1,140,526,44,710,0.19718309859154900,0.19718309859154900
2011-01-17,2011,1,194,689,59,942,0.2059447983014860,0.2059447983014860
2011-01-18,2011,1,234,744,73,1051,0.2226450999048530,0.2226450999048530
2011-01-19,2011,1,338,1080,121,1539,0.21962313190383400,0.21962313190383400
2011-01-20,2011,1,372,1060,109,1541,0.24140168721609300,0.24140168721609300
2011-01-21,2011,1,333,932,94,1359,0.24503311258278100,0.24503311258278100
2011-01-22,2011,1,214,993,81,1288,0.16614906832298100,0.16614906832298100
2011-01-23,2011,1,133,456,37,626,0.2124600638977640,0.2124600638977640
2011-01-24,2011,1,179,541,47,767,0.2333767926988270,0.2333767926988270
2011-01-25,2011,1,311,948,95,1354,0.22968980797636600,0.22968980797636600
2011-01-26,2011,1,290,736,104,1130,0.25663716814159300,0.25663716814159300
2011-01-27,2011,1,168,545,73,786,0.21374045801526700,0.21374045801526700
2011-01-28,2011,1,322,910,84,1316,0.24468085106383000,0.24468085106383000
2011-01-29,2011,1,237,877,80,1194,0.1984924623115580,0.1984924623115580
2011-01-30,2011,1,170,596,45,811,0.2096177558569670,0.2096177558569670
2011-01-31,2011,1,163,549,48,760,0.21447368421052600,0.21447368421052600
2011-02-01,2011,2,274,764,68,1106,0.24773960216998200,0.24773960216998200
2011-02-02,2011,2,260,868,79,1207,0.21541010770505400,0.21541010770505400
2011-02-03,2011,2,362,985,89,1436,0.2520891364902510,0.2520891364902510
2011-02-04,2011,2,370,1069,91,1530,0.24183006535947700,0.24183006535947700
2011-02-05,2011,2,215,946,77,1238,0.17366720516962800,0.17366720516962800
2011-02-06,2011,2,126,479,47,652,0.19325153374233100,0.19325153374233100
2011-02-07,2011,2,202,607,55,864,0.2337962962962960,0.2337962962962960
2011-02-08,2011,2,299,835,82,1216,0.24588815789473700,0.24588815789473700
2011-02-09,2011,2,377,1029,104,1510,0.24966887417218500,0.24966887417218500
2011-02-10,2011,2,361,1018,108,1487,0.24277067921990600,0.24277067921990600
2011-02-11,2011,2,341,1069,111,1521,0.22419460880999300,0.22419460880999300
2011-02-12,2011,2,244,985,97,1326,0.18401206636500800,0.18401206636500800
2011-02-13,2011,2,171,633,57,861,0.1986062717770040,0.1986062717770040
2011-02-14,2011,2,139,550,51,740,0.18783783783783800,0.18783783783783800
2011-02-15,2011,2,343,967,88,1398,0.2453505007153080,0.2453505007153080
2011-02-16,2011,2,452,1107,103,1662,0.2719614921780990,0.2719614921780990
2011-02-17,2011,2,350,1165,115,1630,0.2147239263803680,0.2147239263803680
2011-02-18,2011,2,354,1185,141,1680,0.21071428571428600,0.21071428571428600
2011-02-19,2011,2,233,902,81,1216,0.19161184210526300,0.19161184210526300
2011-02-20,2011,2,133,579,43,755,0.176158940397351,0.176158940397351
2011-02-21,2011,2,185,601,55,841,0.21997621878715800,0.21997621878715800
2011-02-22,2011,2,296,917,72,1285,0.23035019455252900,0.23035019455252900
2011-02-23,2011,2,280,947,93,1320,0.21212121212121200,0.21212121212121200
2011-02-24,2011,2,272,896,88,1256,0.21656050955414000,0.21656050955414000
2011-02-25,2011,2,252,907,91,1250,0.2016,0.2016
2011-02-26,2011,2,236,905,68,1209,0.19520264681555000,0.19520264681555000
2011-02-27,2011,2,137,676,81,894,0.15324384787472000,0.15324384787472000
2011-02-28,2011,2,180,607,55,842,0.21377672209026100,0.21377672209026100
2011-03-01,2011,3,350,1027,81,1458,0.24005486968449900,0.24005486968449900
2011-03-02,2011,3,380,1122,66,1568,0.2423469387755100,0.2423469387755100
2011-03-03,2011,3,301,976,95,1372,0.2193877551020410,0.2193877551020410
2011-03-04,2011,3,350,1164,94,1608,0.21766169154228900,0.21766169154228900
2011-03-05,2011,3,246,1007,94,1347,0.18262806236080200,0.18262806236080200
2011-03-06,2011,3,144,571,46,761,0.18922470433639900,0.18922470433639900
2011-03-07,2011,3,197,592,46,835,0.23592814371257500,0.23592814371257500
2011-03-08,2011,3,316,1093,81,1490,0.21208053691275200,0.21208053691275200
2011-03-09,2011,3,421,1079,109,1609,0.26165320074580500,0.26165320074580500
2011-03-10,2011,3,256,860,72,1188,0.21548821548821500,0.21548821548821500
2011-03-11,2011,3,342,1128,117,1587,0.21550094517958400,0.21550094517958400
2011-03-12,2011,3,286,1028,77,1391,0.205607476635514,0.205607476635514
2011-03-13,2011,3,128,547,61,736,0.17391304347826100,0.17391304347826100
2011-03-14,2011,3,213,685,60,958,0.22233820459290200,0.22233820459290200
2011-03-15,2011,3,352,1025,88,1465,0.2402730375426620,0.2402730375426620
2011-03-16,2011,3,388,1070,97,1555,0.24951768488746000,0.24951768488746000
2011-03-17,2011,3,248,964,118,1330,0.18646616541353400,0.18646616541353400
2011-03-18,2011,3,275,868,91,1234,0.22285251215559200,0.22285251215559200
2011-03-19,2011,3,257,935,70,1262,0.20364500792393000,0.20364500792393000
2011-03-20,2011,3,154,627,45,826,0.1864406779661020,0.1864406779661020
2011-03-21,2011,3,166,549,48,763,0.21756225425950200,0.21756225425950200
2011-03-22,2011,3,318,1051,93,1462,0.21751025991792100,0.21751025991792100
2011-03-23,2011,3,303,903,87,1293,0.23433874709976800,0.23433874709976800
2011-03-24,2011,3,315,962,98,1375,0.2290909090909090,0.2290909090909090
2011-03-25,2011,3,338,1124,112,1574,0.21473951715374800,0.21473951715374800
2011-03-26,2011,3,197,835,85,1117,0.17636526410026900,0.17636526410026900
2011-03-27,2011,3,132,562,50,744,0.1774193548387100,0.1774193548387100
2011-03-28,2011,3,199,667,71,937,0.21237993596584800,0.21237993596584800
2011-03-29,2011,3,249,791,89,1129,0.22054915854738700,0.22054915854738700
2011-03-30,2011,3,334,970,104,1408,0.2372159090909090,0.2372159090909090
2011-03-31,2011,3,284,826,73,1183,0.2400676246830090,0.2400676246830090
2011-04-01,2011,4,338,1004,99,1441,0.23455933379597500,0.23455933379597500
2011-04-02,2011,4,318,1089,95,1502,0.21171770972037300,0.21171770972037300
2011-04-03,2011,4,164,610,53,827,0.19830713422007300,0.19830713422007300
2011-04-04,2011,4,214,676,72,962,0.22245322245322200,0.22245322245322200
2011-04-05,2011,4,309,940,96,1345,0.22973977695167300,0.22973977695167300
2011-04-06,2011,4,358,1078,101,1537,0.23292127521145100,0.23292127521145100
2011-04-07,2011,4,380,1175,101,1656,0.22946859903381600,0.22946859903381600
2011-04-08,2011,4,352,1096,126,1574,0.22363405336721700,0.22363405336721700
2011-04-09,2011,4,252,991,75,1318,0.19119878603945400,0.19119878603945400
2011-04-10,2011,4,171,607,63,841,0.20332936979786000,0.20332936979786000
2011-04-11,2011,4,246,671,69,986,0.24949290060851900,0.24949290060851900
2011-04-12,2011,4,322,893,90,1305,0.2467432950191570,0.2467432950191570
2011-04-13,2011,4,394,1008,101,1503,0.26214238190286100,0.26214238190286100
2011-04-14,2011,4,364,1129,110,1603,0.22707423580786000,0.22707423580786000
2011-04-15,2011,4,354,1153,126,1633,0.21677893447642400,0.21677893447642400
2011-04-16,2011,4,206,729,58,993,0.20745216515609300,0.20745216515609300
2011-04-17,2011,4,139,541,49,729,0.1906721536351170,0.1906721536351170
2011-04-18,2011,4,202,594,42,838,0.24105011933174200,0.24105011933174200
2011-04-19,2011,4,307,951,95,1353,0.2269031781226900,0.2269031781226900
2011-04-20,2011,4,380,1112,100,1592,0.23869346733668300,0.23869346733668300
2011-04-21,2011,4,309,1015,98,1422,0.21729957805907200,0.21729957805907200
2011-04-22,2011,4,293,999,95,1387,0.21124729632299900,0.21124729632299900
2011-04-23,2011,4,217,801,64,1082,0.20055452865064700,0.20055452865064700
2011-04-24,2011,4,114,374,35,523,0.2179732313575530,0.2179732313575530
2011-04-25,2011,4,210,566,50,826,0.2542372881355930,0.2542372881355930
2011-04-26,2011,4,297,903,87,1287,0.23076923076923100,0.23076923076923100
2011-04-27,2011,4,309,813,93,1215,0.254320987654321,0.254320987654321
2011-04-28,2011,4,271,928,89,1288,0.21040372670807500,0.21040372670807500
2011-04-29,2011,4,290,993,100,1383,0.2096890817064350,0.2096890817064350
2011-04-30,2011,4,215,742,81,1038,0.2071290944123310,0.2071290944123310
2011-05-01,2011,5,151,487,63,701,0.21540656205420800,0.21540656205420800
2011-05-02,2011,5,191,616,62,869,0.21979286536248600,0.21979286536248600
2011-05-03,2011,5,358,1035,89,1482,0.24156545209176800,0.24156545209176800
2011-05-04,2011,5,358,942,82,1382,0.2590448625180900,0.2590448625180900
2011-05-05,2011,5,368,1003,127,1498,0.24566088117490000,0.24566088117490000
2011-05-06,2011,5,306,1055,103,1464,0.20901639344262300,0.20901639344262300
2011-05-07,2011,5,251,837,85,1173,0.21398124467178200,0.21398124467178200
2011-05-08,2011,5,121,447,58,626,0.19329073482428100,0.19329073482428100
2011-05-09,2011,5,260,674,63,997,0.26078234704112300,0.26078234704112300
2011-05-10,2011,5,330,1017,92,1439,0.2293259207783180,0.2293259207783180
2011-05-11,2011,5,376,1125,114,1615,0.23281733746130000,0.23281733746130000
2011-05-12,2011,5,379,1040,86,1505,0.25182724252491700,0.25182724252491700
2011-05-13,2011,5,328,1104,99,1531,0.21423905943827600,0.21423905943827600
2011-05-14,2011,5,263,823,107,1193,0.22045264040234700,0.22045264040234700
2011-05-15,2011,5,161,502,66,729,0.22085048010973900,0.22085048010973900
2011-05-16,2011,5,224,581,48,853,0.26260257913247400,0.26260257913247400
2011-05-17,2011,5,327,911,67,1305,0.25057471264367800,0.25057471264367800
2011-05-18,2011,5,330,968,91,1389,0.23758099352051800,0.23758099352051800
2011-05-19,2011,5,318,987,116,1421,0.22378606615059800,0.22378606615059800
2011-05-20,2011,5,357,967,114,1438,0.2482614742698190,0.2482614742698190
2011-05-21,2011,5,232,919,102,1253,0.18515562649640900,0.18515562649640900
2011-05-22,2011,5,137,565,69,771,0.17769130998703000,0.17769130998703000
2011-05-23,2011,5,228,582,56,866,0.2632794457274830,0.2632794457274830
2011-05-24,2011,5,408,996,102,1506,0.27091633466135500,0.27091633466135500
2011-05-25,2011,5,361,1013,118,1492,0.24195710455764100,0.24195710455764100
2011-05-26,2011,5,313,932,125,1370,0.22846715328467200,0.22846715328467200
2011-05-27,2011,5,292,1031,121,1444,0.20221606648199400,0.20221606648199400
2011-05-28,2011,5,185,706,101,992,0.18649193548387100,0.18649193548387100
2011-05-29,2011,5,123,509,68,700,0.1757142857142860,0.1757142857142860
2011-05-30,2011,5,116,451,49,616,0.18831168831168800,0.18831168831168800
2011-05-31,2011,5,225,739,61,1025,0.21951219512195100,0.21951219512195100
2011-06-01,2011,6,355,991,110,1456,0.2438186813186810,0.2438186813186810
2011-06-02,2011,6,353,997,121,1471,0.2399728076138680,0.2399728076138680
2011-06-03,2011,6,310,1065,121,1496,0.2072192513368980,0.2072192513368980
2011-06-04,2011,6,229,825,88,1142,0.20052539404553400,0.20052539404553400
2011-06-05,2011,6,147,535,61,743,0.19784656796769900,0.19784656796769900
2011-06-06,2011,6,235,579,68,882,0.26643990929705200,0.26643990929705200
2011-06-07,2011,6,289,908,110,1307,0.22111706197398600,0.22111706197398600
2011-06-08,2011,6,385,1056,153,1594,0.24153074027603500,0.24153074027603500
2011-06-09,2011,6,310,810,87,1207,0.25683512841756400,0.25683512841756400
2011-06-10,2011,6,312,983,102,1397,0.22333571939871200,0.22333571939871200
2011-06-11,2011,6,220,739,74,1033,0.21297192642788000,0.21297192642788000
2011-06-12,2011,6,145,624,87,856,0.169392523364486,0.169392523364486
2011-06-13,2011,6,268,546,37,851,0.31492361927144500,0.31492361927144500
2011-06-14,2011,6,275,871,93,1239,0.22195318805488300,0.22195318805488300
2011-06-15,2011,6,400,1042,116,1558,0.25673940949935800,0.25673940949935800
2011-06-16,2011,6,359,1033,109,1501,0.23917388407728200,0.23917388407728200
2011-06-17,2011,6,296,916,135,1347,0.21974758723088300,0.21974758723088300
2011-06-18,2011,6,253,796,120,1169,0.21642429426860600,0.21642429426860600
2011-06-19,2011,6,136,428,62,626,0.21725239616613400,0.21725239616613400
2011-06-20,2011,6,231,547,80,858,0.2692307692307690,0.2692307692307690
2011-06-21,2011,6,401,887,85,1373,0.2920611798980340,0.2920611798980340
2011-06-22,2011,6,361,934,110,1405,0.2569395017793590,0.2569395017793590
2011-06-23,2011,6,293,889,86,1268,0.23107255520504700,0.23107255520504700
2011-06-24,2011,6,279,920,94,1293,0.21577726218097400,0.21577726218097400
2011-06-25,2011,6,207,801,98,1106,0.1871609403254970,0.1871609403254970
2011-06-26,2011,6,159,540,57,756,0.21031746031746000,0.21031746031746000
2011-06-27,2011,6,208,519,56,783,0.2656449553001280,0.2656449553001280
2011-06-28,2011,6,320,899,80,1299,0.24634334103156300,0.24634334103156300
2011-06-29,2011,6,299,835,82,1216,0.24588815789473700,0.24588815789473700
2011-06-30,2011,6,318,842,85,1245,0.25542168674698800,0.25542168674698800
2011-07-01,2011,7,291,938,126,1355,0.21476014760147600,0.21476014760147600
2011-07-02,2011,7,212,725,125,1062,0.19962335216572500,0.19962335216572500
2011-07-03,2011,7,141,537,71,749,0.1882510013351140,0.1882510013351140
2011-07-04,2011,7,122,495,68,685,0.1781021897810220,0.1781021897810220
2011-07-05,2011,7,284,901,88,1273,0.22309505106048700,0.22309505106048700
2011-07-06,2011,7,326,949,107,1382,0.23589001447178000,0.23589001447178000
2011-07-07,2011,7,371,943,123,1437,0.2581767571329160,0.2581767571329160
2011-07-08,2011,7,323,888,85,1296,0.2492283950617280,0.2492283950617280
2011-07-09,2011,7,203,767,99,1069,0.18989710009354500,0.18989710009354500
2011-07-10,2011,7,167,566,85,818,0.2041564792176040,0.2041564792176040
2011-07-11,2011,7,195,550,64,809,0.24103831891223700,0.24103831891223700
2011-07-12,2011,7,299,887,82,1268,0.2358044164037860,0.2358044164037860
2011-07-13,2011,7,334,1004,85,1423,0.23471539002108200,0.23471539002108200
2011-07-14,2011,7,338,943,100,1381,0.2447501810282400,0.2447501810282400
2011-07-15,2011,7,329,924,96,1349,0.24388435878428500,0.24388435878428500
2011-07-16,2011,7,264,821,110,1195,0.22092050209205000,0.22092050209205000
2011-07-17,2011,7,145,505,107,757,0.19154557463672400,0.19154557463672400
2011-07-18,2011,7,191,550,64,805,0.2372670807453420,0.2372670807453420
2011-07-19,2011,7,308,886,93,1287,0.23931623931623900,0.23931623931623900
2011-07-20,2011,7,342,940,87,1369,0.2498173849525200,0.2498173849525200
2011-07-21,2011,7,292,916,114,1322,0.22087745839636900,0.22087745839636900
2011-07-22,2011,7,279,745,101,1125,0.248,0.248
2011-07-23,2011,7,229,673,106,1008,0.22718253968254000,0.22718253968254000
2011-07-24,2011,7,152,566,87,805,0.18881987577639800,0.18881987577639800
2011-07-25,2011,7,178,516,60,754,0.23607427055702900,0.23607427055702900
2011-07-26,2011,7,306,800,94,1200,0.255,0.255
2011-07-27,2011,7,321,980,95,1396,0.22994269340974200,0.22994269340974200
2011-07-28,2011,7,313,822,99,1234,0.25364667747163700,0.25364667747163700
2011-07-29,2011,7,261,811,83,1155,0.22597402597402600,0.22597402597402600
2011-07-30,2011,7,201,673,86,960,0.209375,0.209375
2011-07-31,2011,7,150,479,64,693,0.21645021645021600,0.21645021645021600
2011-08-01,2011,8,213,530,48,791,0.2692793931731990,0.2692793931731990
2011-08-02,2011,8,310,864,80,1254,0.24720893141945800,0.24720893141945800
2011-08-03,2011,8,299,895,98,1292,0.23142414860681100,0.23142414860681100
2011-08-04,2011,8,360,887,110,1357,0.26529108327192300,0.26529108327192300
2011-08-05,2011,8,273,915,143,1331,0.20510894064613100,0.20510894064613100
2011-08-06,2011,8,207,810,94,1111,0.1863186318631860,0.1863186318631860
2011-08-07,2011,8,170,463,87,720,0.2361111111111110,0.2361111111111110
2011-08-08,2011,8,163,526,58,747,0.2182061579651940,0.2182061579651940
2011-08-09,2011,8,304,822,92,1218,0.24958949096880100,0.24958949096880100
2011-08-10,2011,8,339,978,99,1416,0.23940677966101700,0.23940677966101700
2011-08-11,2011,8,279,884,93,1256,0.22213375796178300,0.22213375796178300
2011-08-12,2011,8,314,894,122,1330,0.23609022556391000,0.23609022556391000
2011-08-13,2011,8,248,783,88,1119,0.22162645218945500,0.22162645218945500
2011-08-14,2011,8,112,355,42,509,0.2200392927308450,0.2200392927308450
2011-08-15,2011,8,214,509,44,767,0.2790091264667540,0.2790091264667540
2011-08-16,2011,8,333,879,98,1310,0.25419847328244300,0.25419847328244300
2011-08-17,2011,8,353,1019,111,1483,0.2380310182063390,0.2380310182063390
2011-08-18,2011,8,359,909,99,1367,0.2626188734455010,0.2626188734455010
2011-08-19,2011,8,283,884,94,1261,0.22442505947660600,0.22442505947660600
2011-08-20,2011,8,239,798,95,1132,0.21113074204947000,0.21113074204947000
2011-08-21,2011,8,149,492,63,704,0.21164772727272700,0.21164772727272700
2011-08-22,2011,8,197,515,64,776,0.2538659793814430,0.2538659793814430
2011-08-23,2011,8,307,876,131,1314,0.23363774733637700,0.23363774733637700
2011-08-24,2011,8,320,933,92,1345,0.2379182156133830,0.2379182156133830
2011-08-25,2011,8,297,934,92,1323,0.22448979591836700,0.22448979591836700
2011-08-26,2011,8,271,845,74,1190,0.22773109243697500,0.22773109243697500
2011-08-27,2011,8,108,322,28,458,0.23580786026200900,0.23580786026200900
2011-08-28,2011,8,78,167,8,253,0.308300395256917,0.308300395256917
2011-08-29,2011,8,183,462,28,673,0.27191679049034200,0.27191679049034200
2011-08-30,2011,8,258,761,79,1098,0.23497267759562800,0.23497267759562800
2011-08-31,2011,8,256,791,118,1165,0.21974248927038600,0.21974248927038600
2011-09-01,2011,9,324,1008,105,1437,0.2254697286012530,0.2254697286012530
2011-09-02,2011,9,273,929,102,1304,0.2093558282208590,0.2093558282208590
2011-09-03,2011,9,258,818,97,1173,0.21994884910485900,0.21994884910485900
2011-09-04,2011,9,157,485,65,707,0.22206506364922200,0.22206506364922200
2011-09-05,2011,9,165,416,45,626,0.26357827476038300,0.26357827476038300
2011-09-06,2011,9,190,494,36,720,0.2638888888888890,0.2638888888888890
2011-09-07,2011,9,319,750,75,1144,0.27884615384615400,0.27884615384615400
2011-09-08,2011,9,301,771,81,1153,0.2610581092801390,0.2610581092801390
2011-09-09,2011,9,302,835,78,1215,0.248559670781893,0.248559670781893
2011-09-10,2011,9,227,584,62,873,0.2600229095074460,0.2600229095074460
2011-09-11,2011,9,134,414,38,586,0.22866894197952200,0.22866894197952200
2011-09-12,2011,9,189,477,40,706,0.26770538243626100,0.26770538243626100
2011-09-13,2011,9,280,721,79,1080,0.25925925925925900,0.25925925925925900
2011-09-14,2011,9,287,939,100,1326,0.21644042232277500,0.21644042232277500
2011-09-15,2011,9,270,735,85,1090,0.24770642201834900,0.24770642201834900
2011-09-16,2011,9,290,928,87,1305,0.2222222222222220,0.2222222222222220
2011-09-17,2011,9,250,689,68,1007,0.24826216484607700,0.24826216484607700
2011-09-18,2011,9,136,486,29,651,0.20890937019969300,0.20890937019969300
2011-09-19,2011,9,174,476,48,698,0.2492836676217770,0.2492836676217770
2011-09-20,2011,9,298,819,65,1182,0.2521150592216580,0.2521150592216580
2011-09-21,2011,9,327,845,102,1274,0.2566718995290420,0.2566718995290420
2011-09-22,2011,9,312,892,93,1297,0.2405551272166540,0.2405551272166540
2011-09-23,2011,9,216,735,75,1026,0.21052631578947400,0.21052631578947400
2011-09-24,2011,9,197,683,177,1057,0.18637653736991500,0.18637653736991500
2011-09-25,2011,9,156,464,47,667,0.23388305847076500,0.23388305847076500
2011-09-26,2011,9,190,552,54,796,0.23869346733668300,0.23869346733668300
2011-09-27,2011,9,275,874,101,1250,0.22,0.22
2011-09-28,2011,9,277,929,113,1319,0.2100075815011370,0.2100075815011370
2011-09-29,2011,9,247,817,94,1158,0.21329879101899800,0.21329879101899800
2011-09-30,2011,9,236,702,79,1017,0.232055063913471,0.232055063913471
2011-10-01,2011,10,181,709,327,1217,0.14872637633525100,0.14872637633525100
2011-10-02,2011,10,140,449,57,646,0.21671826625387000,0.21671826625387000
2011-10-03,2011,10,182,480,45,707,0.25742574257425700,0.25742574257425700
2011-10-04,2011,10,449,872,64,1385,0.32418772563176900,0.32418772563176900
2011-10-05,2011,10,383,934,121,1438,0.2663421418637000,0.2663421418637000
2011-10-06,2011,10,327,924,79,1330,0.24586466165413500,0.24586466165413500
2011-10-07,2011,10,360,1002,94,1456,0.24725274725274700,0.24725274725274700
2011-10-08,2011,10,244,878,86,1208,0.20198675496688700,0.20198675496688700
2011-10-09,2011,10,124,484,52,660,0.18787878787878800,0.18787878787878800
2011-10-10,2011,10,201,483,51,735,0.27346938775510200,0.27346938775510200
2011-10-11,2011,10,300,832,51,1183,0.25359256128486900,0.25359256128486900
2011-10-12,2011,10,318,862,81,1261,0.2521808088818400,0.2521808088818400
2011-10-13,2011,10,292,784,90,1166,0.2504288164665520,0.2504288164665520
2011-10-14,2011,10,224,685,53,962,0.23284823284823300,0.23284823284823300
2011-10-15,2011,10,156,497,88,741,0.21052631578947400,0.21052631578947400
2011-10-16,2011,10,191,502,47,740,0.2581081081081080,0.2581081081081080
2011-10-17,2011,10,240,566,47,853,0.2813599062133650,0.2813599062133650
2011-10-18,2011,10,340,939,91,1370,0.24817518248175200,0.24817518248175200
2011-10-19,2011,10,380,793,72,1245,0.30522088353413700,0.30522088353413700
2011-10-20,2011,10,394,997,84,1475,0.2671186440677970,0.2671186440677970
2011-10-21,2011,10,356,1021,139,1516,0.23482849604221600,0.23482849604221600
2011-10-22,2011,10,209,771,60,1040,0.20096153846153800,0.20096153846153800
2011-10-23,2011,10,146,559,47,752,0.19414893617021300,0.19414893617021300
2011-10-24,2011,10,205,584,56,845,0.24260355029585800,0.24260355029585800
2011-10-25,2011,10,313,922,105,1340,0.2335820895522390,0.2335820895522390
2011-10-26,2011,10,334,1013,103,1450,0.2303448275862070,0.2303448275862070
2011-10-27,2011,10,299,731,81,1111,0.26912691269126900,0.26912691269126900
2011-10-28,2011,10,301,817,61,1179,0.2553011026293470,0.2553011026293470
2011-10-29,2011,10,148,492,52,692,0.2138728323699420,0.2138728323699420
2011-10-30,2011,10,138,449,49,636,0.2169811320754720,0.2169811320754720
2011-10-31,2011,10,160,442,47,649,0.2465331278890600,0.2465331278890600
2011-11-01,2011,11,328,997,57,1382,0.23733719247467400,0.23733719247467400
2011-11-02,2011,11,317,967,83,1367,0.23189465983906400,0.23189465983906400
2011-11-03,2011,11,333,974,116,1423,0.23401264933239600,0.23401264933239600
2011-11-04,2011,11,334,938,78,1350,0.2474074074074070,0.2474074074074070
2011-11-05,2011,11,232,799,96,1127,0.20585625554569700,0.20585625554569700
2011-11-06,2011,11,153,575,37,765,0.2,0.2
2011-11-07,2011,11,204,602,73,879,0.23208191126279900,0.23208191126279900
2011-11-08,2011,11,255,808,71,1134,0.22486772486772500,0.22486772486772500
2011-11-09,2011,11,381,1002,89,1472,0.25883152173913000,0.25883152173913000
2011-11-10,2011,11,330,998,90,1418,0.23272214386459800,0.23272214386459800
2011-11-11,2011,11,275,882,55,1212,0.2268976897689770,0.2268976897689770
2011-11-12,2011,11,218,782,74,1074,0.20297951582867800,0.20297951582867800
2011-11-13,2011,11,133,538,44,715,0.18601398601398600,0.18601398601398600
2011-11-14,2011,11,196,537,64,797,0.24592220828105400,0.24592220828105400
2011-11-15,2011,11,239,887,144,1270,0.18818897637795300,0.18818897637795300
2011-11-16,2011,11,376,780,59,1215,0.3094650205761320,0.3094650205761320
2011-11-17,2011,11,275,769,195,1239,0.22195318805488300,0.22195318805488300
2011-11-18,2011,11,275,934,68,1277,0.2153484729835550,0.2153484729835550
2011-11-19,2011,11,233,829,65,1127,0.2067435669920140,0.2067435669920140
2011-11-20,2011,11,143,493,52,688,0.20784883720930200,0.20784883720930200
2011-11-21,2011,11,179,587,54,820,0.21829268292682900,0.21829268292682900
2011-11-22,2011,11,251,790,52,1093,0.22964318389753000,0.22964318389753000
2011-11-23,2011,11,237,692,45,974,0.2433264887063660,0.2433264887063660
2011-11-24,2011,11,53,170,20,243,0.21810699588477400,0.21810699588477400
2011-11-25,2011,11,246,887,78,1211,0.20313790255986800,0.20313790255986800
2011-11-26,2011,11,229,770,78,1077,0.21262766945218200,0.21262766945218200
2011-11-27,2011,11,173,558,42,773,0.2238033635187580,0.2238033635187580
2011-11-28,2011,11,224,688,117,1029,0.21768707482993200,0.21768707482993200
2011-11-29,2011,11,287,851,95,1233,0.23276561232765600,0.23276561232765600
2011-11-30,2011,11,268,813,114,1195,0.22426778242677800,0.22426778242677800
2011-12-01,2011,12,314,1010,132,1456,0.21565934065934100,0.21565934065934100
2011-12-02,2011,12,332,998,114,1444,0.2299168975069250,0.2299168975069250
2011-12-03,2011,12,253,887,110,1250,0.2024,0.2024
2011-12-04,2011,12,165,586,61,812,0.20320197044335000,0.20320197044335000
2011-12-05,2011,12,220,594,49,863,0.2549246813441480,0.2549246813441480
2011-12-06,2011,12,350,836,49,1235,0.2834008097165990,0.2834008097165990
2011-12-07,2011,12,395,821,94,1310,0.3015267175572520,0.3015267175572520
2011-12-08,2011,12,279,897,107,1283,0.21745908028059200,0.21745908028059200
2011-12-09,2011,12,255,887,84,1226,0.20799347471451900,0.20799347471451900
2011-12-10,2011,12,216,746,64,1026,0.21052631578947400,0.21052631578947400
2011-12-11,2011,12,129,481,45,655,0.1969465648854960,0.1969465648854960
2011-12-12,2011,12,168,530,33,731,0.22982216142270900,0.22982216142270900
2011-12-13,2011,12,333,856,84,1273,0.2615868028279650,0.2615868028279650
2011-12-14,2011,12,307,862,120,1289,0.23816912335143500,0.23816912335143500
2011-12-15,2011,12,339,906,72,1317,0.25740318906605900,0.25740318906605900
2011-12-16,2011,12,315,856,70,1241,0.25382755842062900,0.25382755842062900
2011-12-17,2011,12,235,802,46,1083,0.2169898430286240,0.2169898430286240
2011-12-18,2011,12,143,421,34,598,0.2391304347826090,0.2391304347826090
2011-12-19,2011,12,119,368,21,508,0.234251968503937,0.234251968503937
2011-12-20,2011,12,295,815,56,1166,0.25300171526586600,0.25300171526586600
2011-12-21,2011,12,301,770,53,1124,0.2677935943060500,0.2677935943060500
2011-12-22,2011,12,251,752,62,1065,0.23568075117370900,0.23568075117370900
2011-12-23,2011,12,168,525,41,734,0.22888283378746600,0.22888283378746600
2011-12-24,2011,12,98,264,8,370,0.2648648648648650,0.2648648648648650
2011-12-25,2011,12,60,145,6,211,0.2843601895734600,0.2843601895734600
2011-12-26,2011,12,118,389,29,536,0.22014925373134300,0.22014925373134300
2011-12-27,2011,12,182,630,47,859,0.21187427240977900,0.21187427240977900
2011-12-28,2011,12,280,797,56,1133,0.2471315092674320,0.2471315092674320
2011-12-29,2011,12,260,789,69,1118,0.23255813953488400,0.23255813953488400
2011-12-30,2011,12,251,632,72,955,0.2628272251308900,0.2628272251308900
2011-12-31,2011,12,157,373,45,575,0.27304347826087000,0.27304347826087000
2012-01-01,2012,1,155,490,95,740,0.20945945945945900,0.20945945945945900
2012-01-02,2012,1,169,553,34,756,0.22354497354497400,0.22354497354497400
2012-01-03,2012,1,270,812,47,1129,0.2391496899911430,0.2391496899911430
2012-01-04,2012,1,318,889,88,1295,0.24555984555984600,0.24555984555984600
2012-01-05,2012,1,317,1007,91,1415,0.22402826855123700,0.22402826855123700
2012-01-06,2012,1,296,1114,92,1502,0.1970705725699070,0.1970705725699070
2012-01-07,2012,1,239,862,91,1192,0.200503355704698,0.200503355704698
2012-01-08,2012,1,139,487,43,669,0.2077727952167410,0.2077727952167410
2012-01-09,2012,1,190,562,62,814,0.2334152334152330,0.2334152334152330
2012-01-10,2012,1,291,1078,95,1464,0.1987704918032790,0.1987704918032790
2012-01-11,2012,1,430,1026,99,1555,0.2765273311897110,0.2765273311897110
2012-01-12,2012,1,297,1035,74,1406,0.2112375533428170,0.2112375533428170
2012-01-13,2012,1,290,1061,106,1457,0.19903912148249800,0.19903912148249800
2012-01-14,2012,1,252,940,62,1254,0.20095693779904300,0.20095693779904300
2012-01-15,2012,1,115,488,31,634,0.18138801261829700,0.18138801261829700
2012-01-16,2012,1,192,593,56,841,0.22829964328180700,0.22829964328180700
2012-01-17,2012,1,329,1006,135,1470,0.22380952380952400,0.22380952380952400
2012-01-18,2012,1,378,1106,123,1607,0.23522090852520200,0.23522090852520200
2012-01-19,2012,1,289,905,130,1324,0.21827794561933500,0.21827794561933500
2012-01-20,2012,1,351,1115,121,1587,0.22117202268431000,0.22117202268431000
2012-01-21,2012,1,164,675,82,921,0.1780673181324650,0.1780673181324650
2012-01-22,2012,1,92,515,72,679,0.13549337260677500,0.13549337260677500
2012-01-23,2012,1,220,653,54,927,0.2373247033441210,0.2373247033441210
2012-01-24,2012,1,323,1025,90,1438,0.22461752433936000,0.22461752433936000
2012-01-25,2012,1,364,928,93,1385,0.2628158844765340,0.2628158844765340
2012-01-26,2012,1,295,907,75,1277,0.23101018010963200,0.23101018010963200
2012-01-27,2012,1,353,927,110,1390,0.2539568345323740,0.2539568345323740
2012-01-28,2012,1,244,879,74,1197,0.20384294068504600,0.20384294068504600
2012-01-29,2012,1,118,573,68,759,0.155467720685112,0.155467720685112
2012-01-30,2012,1,207,602,62,871,0.23765786452353600,0.23765786452353600
2012-01-31,2012,1,281,886,69,1236,0.2273462783171520,0.2273462783171520
2012-02-01,2012,2,438,1181,97,1716,0.25524475524475500,0.25524475524475500
2012-02-02,2012,2,351,1083,76,1510,0.2324503311258280,0.2324503311258280
2012-02-03,2012,2,317,1048,125,1490,0.212751677852349,0.212751677852349
2012-02-04,2012,2,220,837,94,1151,0.19113814074717600,0.19113814074717600
2012-02-05,2012,2,115,410,48,573,0.2006980802792320,0.2006980802792320
2012-02-06,2012,2,188,585,59,832,0.22596153846153800,0.22596153846153800
2012-02-07,2012,2,281,787,80,1148,0.24477351916376300,0.24477351916376300
2012-02-08,2012,2,333,1021,90,1444,0.23060941828254800,0.23060941828254800
2012-02-09,2012,2,374,963,108,1445,0.25882352941176500,0.25882352941176500
2012-02-10,2012,2,400,1116,96,1612,0.24813895781637700,0.24813895781637700
2012-02-11,2012,2,210,921,73,1204,0.1744186046511630,0.1744186046511630
2012-02-12,2012,2,154,531,55,740,0.20810810810810800,0.20810810810810800
2012-02-13,2012,2,184,747,65,996,0.18473895582329300,0.18473895582329300
2012-02-14,2012,2,249,748,64,1061,0.23468426013195100,0.23468426013195100
2012-02-15,2012,2,360,1000,79,1439,0.2501737317581650,0.2501737317581650
2012-02-16,2012,2,335,947,93,1375,0.24363636363636400,0.24363636363636400
2012-02-17,2012,2,326,1060,79,1465,0.22252559726962500,0.22252559726962500
2012-02-18,2012,2,234,860,83,1177,0.1988105352591330,0.1988105352591330
2012-02-19,2012,2,154,578,55,787,0.19567979669631500,0.19567979669631500
2012-02-20,2012,2,160,596,61,817,0.19583843329253400,0.19583843329253400
2012-02-21,2012,2,258,900,73,1231,0.20958570268074700,0.20958570268074700
2012-02-22,2012,2,321,952,82,1355,0.23690036900369000,0.23690036900369000
2012-02-23,2012,2,271,915,82,1268,0.2137223974763410,0.2137223974763410
2012-02-24,2012,2,222,854,73,1149,0.19321148825065300,0.19321148825065300
2012-02-25,2012,2,206,866,74,1146,0.17975567190226900,0.17975567190226900
2012-02-26,2012,2,120,597,61,778,0.15424164524421600,0.15424164524421600
2012-02-27,2012,2,236,621,57,914,0.25820568927789900,0.25820568927789900
2012-02-28,2012,2,304,894,78,1276,0.23824451410658300,0.23824451410658300
2012-02-29,2012,2,285,711,56,1052,0.2709125475285170,0.2709125475285170
2012-03-01,2012,3,299,929,74,1302,0.22964669738863300,0.22964669738863300
2012-03-02,2012,3,340,990,83,1413,0.24062278839348900,0.24062278839348900
2012-03-03,2012,3,252,762,63,1077,0.233983286908078,0.233983286908078
2012-03-04,2012,3,147,567,81,795,0.18490566037735800,0.18490566037735800
2012-03-05,2012,3,201,703,72,976,0.20594262295082000,0.20594262295082000
2012-03-06,2012,3,344,1010,104,1458,0.23593964334705100,0.23593964334705100
2012-03-07,2012,3,389,1204,137,1730,0.22485549132948000,0.22485549132948000
2012-03-08,2012,3,308,1135,150,1593,0.1933458882611430,0.1933458882611430
2012-03-09,2012,3,311,1023,109,1443,0.21552321552321600,0.21552321552321600
2012-03-10,2012,3,287,849,91,1227,0.2339038304808480,0.2339038304808480
2012-03-11,2012,3,127,596,70,793,0.1601513240857500,0.1601513240857500
2012-03-12,2012,3,232,689,66,987,0.23505572441742700,0.23505572441742700
2012-03-13,2012,3,373,1010,86,1469,0.2539142273655550,0.2539142273655550
2012-03-14,2012,3,381,1022,113,1516,0.25131926121372000,0.25131926121372000
2012-03-15,2012,3,299,974,97,1370,0.21824817518248200,0.21824817518248200
2012-03-16,2012,3,279,913,98,1290,0.21627906976744200,0.21627906976744200
2012-03-17,2012,3,216,879,85,1180,0.18305084745762700,0.18305084745762700
2012-03-18,2012,3,161,655,93,909,0.1771177117711770,0.1771177117711770
2012-03-19,2012,3,234,663,71,968,0.24173553719008300,0.24173553719008300
2012-03-20,2012,3,314,927,63,1304,0.24079754601227000,0.24079754601227000
2012-03-21,2012,3,340,1042,112,1494,0.22757697456492600,0.22757697456492600
2012-03-22,2012,3,356,1005,110,1471,0.24201223657375900,0.24201223657375900
2012-03-23,2012,3,368,970,105,1443,0.255024255024255,0.255024255024255
2012-03-24,2012,3,197,917,92,1206,0.16334991708126000,0.16334991708126000
2012-03-25,2012,3,129,523,55,707,0.18246110325318200,0.18246110325318200
2012-03-26,2012,3,188,666,66,920,0.20434782608695700,0.20434782608695700
2012-03-27,2012,3,299,951,90,1340,0.22313432835820900,0.22313432835820900
2012-03-28,2012,3,374,970,122,1466,0.2551159618008190,0.2551159618008190
2012-03-29,2012,3,254,943,86,1283,0.1979734996102880,0.1979734996102880
2012-03-30,2012,3,240,859,98,1197,0.20050125313283200,0.20050125313283200
2012-03-31,2012,3,178,751,82,1011,0.17606330365974300,0.17606330365974300
2012-04-01,2012,4,166,573,70,809,0.20519159456118700,0.20519159456118700
2012-04-02,2012,4,242,571,51,864,0.2800925925925930,0.2800925925925930
2012-04-03,2012,4,335,996,91,1422,0.23558368495077400,0.23558368495077400
2012-04-04,2012,4,383,1020,114,1517,0.2524719841793010,0.2524719841793010
2012-04-05,2012,4,357,955,100,1412,0.2528328611898020,0.2528328611898020
2012-04-06,2012,4,284,945,92,1321,0.2149886449659350,0.2149886449659350
2012-04-07,2012,4,240,786,79,1105,0.2171945701357470,0.2171945701357470
2012-04-08,2012,4,115,358,35,508,0.2263779527559060,0.2263779527559060
2012-04-09,2012,4,165,528,51,744,0.2217741935483870,0.2217741935483870
2012-04-10,2012,4,294,885,73,1252,0.23482428115016000,0.23482428115016000
2012-04-11,2012,4,315,888,96,1299,0.24249422632794500,0.24249422632794500
2012-04-12,2012,4,322,837,71,1230,0.26178861788617900,0.26178861788617900
2012-04-13,2012,4,286,849,80,1215,0.2353909465020580,0.2353909465020580
2012-04-14,2012,4,227,721,86,1034,0.21953578336557100,0.21953578336557100
2012-04-15,2012,4,176,629,63,868,0.20276497695852500,0.20276497695852500
2012-04-16,2012,4,189,633,71,893,0.2116461366181410,0.2116461366181410
2012-04-17,2012,4,334,993,89,1416,0.23587570621468900,0.23587570621468900
2012-04-18,2012,4,346,1022,91,1459,0.2371487320082250,0.2371487320082250
2012-04-19,2012,4,350,922,96,1368,0.25584795321637400,0.25584795321637400
2012-04-20,2012,4,307,1066,112,1485,0.20673400673400700,0.20673400673400700
2012-04-21,2012,4,197,826,94,1117,0.17636526410026900,0.17636526410026900
2012-04-22,2012,4,103,476,49,628,0.16401273885350300,0.16401273885350300
2012-04-23,2012,4,225,550,53,828,0.2717391304347830,0.2717391304347830
2012-04-24,2012,4,234,678,76,988,0.23684210526315800,0.23684210526315800
2012-04-25,2012,4,337,988,92,1417,0.23782639378969700,0.23782639378969700
2012-04-26,2012,4,313,829,84,1226,0.2553017944535070,0.2553017944535070
2012-04-27,2012,4,283,972,111,1366,0.20717423133235700,0.20717423133235700
2012-04-28,2012,4,215,781,90,1086,0.19797421731123400,0.19797421731123400
2012-04-29,2012,4,178,531,55,764,0.23298429319371700,0.23298429319371700
2012-04-30,2012,4,201,535,55,791,0.25410872313527200,0.25410872313527200
2012-05-01,2012,5,274,746,106,1126,0.2433392539964480,0.2433392539964480
2012-05-02,2012,5,343,887,78,1308,0.2622324159021410,0.2622324159021410
2012-05-03,2012,5,429,1004,110,1543,0.2780298120544390,0.2780298120544390
2012-05-04,2012,5,307,968,106,1381,0.222302679217958,0.222302679217958
2012-05-05,2012,5,236,766,94,1096,0.21532846715328500,0.21532846715328500
2012-05-06,2012,5,145,555,60,760,0.19078947368421100,0.19078947368421100
2012-05-07,2012,5,215,606,65,886,0.24266365688487600,0.24266365688487600
2012-05-08,2012,5,395,958,130,1483,0.2663519892110590,0.2663519892110590
2012-05-09,2012,5,369,1075,142,1586,0.23266078184111000,0.23266078184111000
2012-05-10,2012,5,333,1011,135,1479,0.22515212981744400,0.22515212981744400
2012-05-11,2012,5,320,1001,112,1433,0.22330774598743900,0.22330774598743900
2012-05-12,2012,5,208,751,109,1068,0.1947565543071160,0.1947565543071160
2012-05-13,2012,5,123,473,66,662,0.18580060422960700,0.18580060422960700
2012-05-14,2012,5,174,522,41,737,0.23609226594301200,0.23609226594301200
2012-05-15,2012,5,347,841,65,1253,0.27693535514764600,0.27693535514764600
2012-05-16,2012,5,404,972,109,1485,0.27205387205387200,0.27205387205387200
2012-05-17,2012,5,361,976,96,1433,0.25191905094208000,0.25191905094208000
2012-05-18,2012,5,321,894,100,1315,0.244106463878327,0.244106463878327
2012-05-19,2012,5,226,725,71,1022,0.22113502935420700,0.22113502935420700
2012-05-20,2012,5,158,550,66,774,0.2041343669250650,0.2041343669250650
2012-05-21,2012,5,183,499,56,738,0.24796747967479700,0.24796747967479700
2012-05-22,2012,5,359,895,76,1330,0.2699248120300750,0.2699248120300750
2012-05-23,2012,5,364,967,81,1412,0.2577903682719550,0.2577903682719550
2012-05-24,2012,5,346,813,82,1241,0.27880741337630900,0.27880741337630900
2012-05-25,2012,5,292,959,123,1374,0.21251819505094600,0.21251819505094600
2012-05-26,2012,5,230,692,91,1013,0.22704837117472900,0.22704837117472900
2012-05-27,2012,5,137,484,46,667,0.20539730134932500,0.20539730134932500
2012-05-28,2012,5,125,361,45,531,0.23540489642184600,0.23540489642184600
2012-05-29,2012,5,267,745,78,1090,0.24495412844036700,0.24495412844036700
2012-05-30,2012,5,318,840,75,1233,0.25790754257907500,0.25790754257907500
2012-05-31,2012,5,340,921,91,1352,0.2514792899408280,0.2514792899408280
2012-06-01,2012,6,358,1031,89,1478,0.2422192151556160,0.2422192151556160
2012-06-02,2012,6,213,714,91,1018,0.20923379174852700,0.20923379174852700
2012-06-03,2012,6,140,569,62,771,0.1815823605706870,0.1815823605706870
2012-06-04,2012,6,144,536,38,718,0.20055710306406700,0.20055710306406700
2012-06-05,2012,6,369,908,86,1363,0.2707263389581810,0.2707263389581810
2012-06-06,2012,6,384,1009,99,1492,0.257372654155496,0.257372654155496
2012-06-07,2012,6,358,951,97,1406,0.2546230440967280,0.2546230440967280
2012-06-08,2012,6,302,811,98,1211,0.24938067712634200,0.24938067712634200
2012-06-09,2012,6,194,701,73,968,0.20041322314049600,0.20041322314049600
2012-06-10,2012,6,160,604,96,860,0.18604651162790700,0.18604651162790700
2012-06-11,2012,6,209,533,49,791,0.26422250316055600,0.26422250316055600
2012-06-12,2012,6,266,727,69,1062,0.2504708097928440,0.2504708097928440
2012-06-13,2012,6,350,836,122,1308,0.26758409785932700,0.26758409785932700
2012-06-14,2012,6,304,745,76,1125,0.2702222222222220,0.2702222222222220
2012-06-15,2012,6,333,874,93,1300,0.2561538461538460,0.2561538461538460
2012-06-16,2012,6,197,724,92,1013,0.19447186574531100,0.19447186574531100
2012-06-17,2012,6,114,454,58,626,0.18210862619808300,0.18210862619808300
2012-06-18,2012,6,192,579,85,856,0.22429906542056100,0.22429906542056100
2012-06-19,2012,6,348,909,98,1355,0.2568265682656830,0.2568265682656830
2012-06-20,2012,6,317,863,125,1305,0.24291187739463600,0.24291187739463600
2012-06-21,2012,6,314,847,109,1270,0.247244094488189,0.247244094488189
2012-06-22,2012,6,306,804,103,1213,0.2522671063478980,0.2522671063478980
2012-06-23,2012,6,172,677,84,933,0.18435155412647400,0.18435155412647400
2012-06-24,2012,6,179,473,63,715,0.25034965034965000,0.25034965034965000
2012-06-25,2012,6,182,473,44,699,0.2603719599427750,0.2603719599427750
2012-06-26,2012,6,251,559,58,868,0.2891705069124420,0.2891705069124420
2012-06-27,2012,6,287,925,80,1292,0.22213622291021700,0.22213622291021700
2012-06-28,2012,6,283,831,86,1200,0.23583333333333300,0.23583333333333300
2012-06-29,2012,6,250,849,83,1182,0.21150592216582100,0.21150592216582100
2012-06-30,2012,6,169,678,101,948,0.17827004219409300,0.17827004219409300
2012-07-01,2012,7,128,488,57,673,0.1901931649331350,0.1901931649331350
2012-07-02,2012,7,215,534,46,795,0.27044025157232700,0.27044025157232700
2012-07-03,2012,7,394,876,87,1357,0.290346352247605,0.290346352247605
2012-07-04,2012,7,192,591,83,866,0.22170900692840600,0.22170900692840600
2012-07-05,2012,7,342,859,77,1278,0.2676056338028170,0.2676056338028170
2012-07-06,2012,7,293,800,100,1193,0.24559932942162600,0.24559932942162600
2012-07-07,2012,7,213,687,99,999,0.2132132132132130,0.2132132132132130
2012-07-08,2012,7,157,460,57,674,0.23293768545994100,0.23293768545994100
2012-07-09,2012,7,183,544,56,783,0.23371647509578500,0.23371647509578500
2012-07-10,2012,7,372,874,96,1342,0.27719821162444100,0.27719821162444100
2012-07-11,2012,7,375,924,111,1410,0.26595744680851100,0.26595744680851100
2012-07-12,2012,7,357,954,116,1427,0.2501751927119830,0.2501751927119830
2012-07-13,2012,7,334,851,90,1275,0.2619607843137260,0.2619607843137260
2012-07-14,2012,7,237,770,106,1113,0.21293800539083600,0.21293800539083600
2012-07-15,2012,7,168,472,83,723,0.23236514522821600,0.23236514522821600
2012-07-16,2012,7,211,494,61,766,0.2754569190600520,0.2754569190600520
2012-07-17,2012,7,328,841,93,1262,0.25990491283676700,0.25990491283676700
2012-07-18,2012,7,299,797,77,1173,0.2549019607843140,0.2549019607843140
2012-07-19,2012,7,350,871,101,1322,0.264750378214826,0.264750378214826
2012-07-20,2012,7,267,769,90,1126,0.23712255772646500,0.23712255772646500
2012-07-21,2012,7,229,791,105,1125,0.20355555555555600,0.20355555555555600
2012-07-22,2012,7,166,616,70,852,0.19483568075117400,0.19483568075117400
2012-07-23,2012,7,192,552,53,797,0.24090338770389000,0.24090338770389000
2012-07-24,2012,7,306,790,98,1194,0.2562814070351760,0.2562814070351760
2012-07-25,2012,7,394,949,104,1447,0.2722874913614380,0.2722874913614380
2012-07-26,2012,7,325,862,83,1270,0.2559055118110240,0.2559055118110240
2012-07-27,2012,7,269,864,90,1223,0.21995094031071100,0.21995094031071100
2012-07-28,2012,7,270,727,97,1094,0.24680073126142600,0.24680073126142600
2012-07-29,2012,7,152,512,77,741,0.20512820512820500,0.20512820512820500
2012-07-30,2012,7,182,512,71,765,0.23790849673202600,0.23790849673202600
2012-07-31,2012,7,300,736,100,1136,0.2640845070422540,0.2640845070422540
2012-08-01,2012,8,348,902,139,1389,0.2505399568034560,0.2505399568034560
2012-08-02,2012,8,350,940,139,1429,0.244926522043387,0.244926522043387
2012-08-03,2012,8,314,993,123,1430,0.21958041958042000,0.21958041958042000
2012-08-04,2012,8,280,782,149,1211,0.23121387283237000,0.23121387283237000
2012-08-05,2012,8,150,546,95,791,0.18963337547408300,0.18963337547408300
2012-08-06,2012,8,201,516,51,768,0.26171875,0.26171875
2012-08-07,2012,8,332,802,75,1209,0.2746071133167910,0.2746071133167910
2012-08-08,2012,8,417,942,102,1461,0.28542094455852200,0.28542094455852200
2012-08-09,2012,8,316,961,132,1409,0.22427253371185200,0.22427253371185200
2012-08-10,2012,8,296,814,136,1246,0.2375601926163720,0.2375601926163720
2012-08-11,2012,8,240,824,107,1171,0.2049530315969260,0.2049530315969260
2012-08-12,2012,8,177,597,96,870,0.20344827586206900,0.20344827586206900
2012-08-13,2012,8,171,546,53,770,0.22207792207792200,0.22207792207792200
2012-08-14,2012,8,309,846,99,1254,0.24641148325358900,0.24641148325358900
2012-08-15,2012,8,340,815,81,1236,0.2750809061488670,0.2750809061488670
2012-08-16,2012,8,324,909,115,1348,0.2403560830860530,0.2403560830860530
2012-08-17,2012,8,304,848,111,1263,0.24069675376088700,0.24069675376088700
2012-08-18,2012,8,214,739,97,1050,0.2038095238095240,0.2038095238095240
2012-08-19,2012,8,199,535,85,819,0.24297924297924300,0.24297924297924300
2012-08-20,2012,8,203,584,57,844,0.24052132701421800,0.24052132701421800
2012-08-21,2012,8,307,874,107,1288,0.23835403726708100,0.23835403726708100
2012-08-22,2012,8,378,848,104,1330,0.28421052631578900,0.28421052631578900
2012-08-23,2012,8,344,831,90,1265,0.2719367588932810,0.2719367588932810
2012-08-24,2012,8,306,894,131,1331,0.2299023290758830,0.2299023290758830
2012-08-25,2012,8,220,768,100,1088,0.20220588235294100,0.20220588235294100
2012-08-26,2012,8,171,490,54,715,0.23916083916083900,0.23916083916083900
2012-08-27,2012,8,187,498,48,733,0.2551159618008190,0.2551159618008190
2012-08-28,2012,8,296,757,79,1132,0.26148409893992900,0.26148409893992900
2012-08-29,2012,8,340,832,72,1244,0.2733118971061090,0.2733118971061090
2012-08-30,2012,8,282,742,63,1087,0.2594296228150870,0.2594296228150870
2012-08-31,2012,8,219,744,82,1045,0.20956937799043100,0.20956937799043100
2012-09-01,2012,9,247,695,82,1024,0.2412109375,0.2412109375
2012-09-02,2012,9,157,550,84,791,0.19848293299620700,0.19848293299620700
2012-09-03,2012,9,146,535,74,755,0.19337748344370900,0.19337748344370900
2012-09-04,2012,9,229,702,58,989,0.23154701718908000,0.23154701718908000
2012-09-05,2012,9,324,787,94,1205,0.2688796680497930,0.2688796680497930
2012-09-06,2012,9,289,874,87,1250,0.2312,0.2312
2012-09-07,2012,9,331,877,110,1318,0.2511380880121400,0.2511380880121400
2012-09-08,2012,9,258,665,80,1003,0.2572283150548360,0.2572283150548360
2012-09-09,2012,9,161,475,72,708,0.2274011299435030,0.2274011299435030
2012-09-10,2012,9,218,555,48,821,0.26552984165651600,0.26552984165651600
2012-09-11,2012,9,339,866,71,1276,0.2656739811912230,0.2656739811912230
2012-09-12,2012,9,453,1016,100,1569,0.2887189292543020,0.2887189292543020
2012-09-13,2012,9,311,768,78,1157,0.26879861711322400,0.26879861711322400
2012-09-14,2012,9,337,886,92,1315,0.25627376425855500,0.25627376425855500
2012-09-15,2012,9,227,796,104,1127,0.20141969831410800,0.20141969831410800
2012-09-16,2012,9,167,498,90,755,0.22119205298013200,0.22119205298013200
2012-09-17,2012,9,146,523,191,860,0.1697674418604650,0.1697674418604650
2012-09-18,2012,9,237,716,79,1032,0.22965116279069800,0.22965116279069800
2012-09-19,2012,9,325,913,108,1346,0.24145616641901900,0.24145616641901900
2012-09-20,2012,9,300,986,111,1397,0.2147458840372230,0.2147458840372230
2012-09-21,2012,9,323,954,122,1399,0.23087919942816300,0.23087919942816300
2012-09-22,2012,9,207,821,96,1124,0.18416370106761600,0.18416370106761600
2012-09-23,2012,9,164,519,69,752,0.21808510638297900,0.21808510638297900
2012-09-24,2012,9,205,470,63,738,0.2777777777777780,0.2777777777777780
2012-09-25,2012,9,270,794,96,1160,0.23275862068965500,0.23275862068965500
2012-09-26,2012,9,329,857,125,1311,0.2509534706331050,0.2509534706331050
2012-09-27,2012,9,277,782,84,1143,0.24234470691163600,0.24234470691163600
2012-09-28,2012,9,269,720,91,1080,0.2490740740740740,0.2490740740740740
2012-09-29,2012,9,187,703,87,977,0.19140225179119800,0.19140225179119800
2012-09-30,2012,9,138,503,35,676,0.20414201183432000,0.20414201183432000
2012-10-01,2012,10,228,554,64,846,0.2695035460992910,0.2695035460992910
2012-10-02,2012,10,315,750,79,1144,0.27534965034965000,0.27534965034965000
2012-10-03,2012,10,389,1044,109,1542,0.2522697795071340,0.2522697795071340
2012-10-04,2012,10,360,934,113,1407,0.255863539445629,0.255863539445629
2012-10-05,2012,10,306,1008,102,1416,0.21610169491525400,0.21610169491525400
2012-10-06,2012,10,259,867,88,1214,0.21334431630972000,0.21334431630972000
2012-10-07,2012,10,124,474,63,661,0.1875945537065050,0.1875945537065050
2012-10-08,2012,10,173,608,61,842,0.20546318289786200,0.20546318289786200
2012-10-09,2012,10,301,927,90,1318,0.2283763277693480,0.2283763277693480
2012-10-10,2012,10,349,913,82,1344,0.25967261904761900,0.25967261904761900
2012-10-11,2012,10,353,923,109,1385,0.2548736462093860,0.2548736462093860
2012-10-12,2012,10,313,913,109,1335,0.2344569288389510,0.2344569288389510
2012-10-13,2012,10,267,764,85,1116,0.239247311827957,0.239247311827957
2012-10-14,2012,10,139,561,59,759,0.1831357048748350,0.1831357048748350
2012-10-15,2012,10,244,558,51,853,0.28604923798358700,0.28604923798358700
2012-10-16,2012,10,319,839,89,1247,0.2558139534883720,0.2558139534883720
2012-10-17,2012,10,347,982,104,1433,0.2421493370551290,0.2421493370551290
2012-10-18,2012,10,404,958,111,1473,0.2742701968771220,0.2742701968771220
2012-10-19,2012,10,275,885,87,1247,0.22052927024859700,0.22052927024859700
2012-10-20,2012,10,251,861,106,1218,0.20607553366174100,0.20607553366174100
2012-10-21,2012,10,127,469,65,661,0.19213313161875900,0.19213313161875900
2012-10-22,2012,10,205,579,60,844,0.24289099526066400,0.24289099526066400
2012-10-23,2012,10,345,799,83,1227,0.28117359413202900,0.28117359413202900
2012-10-24,2012,10,323,938,91,1352,0.23890532544378700,0.23890532544378700
2012-10-25,2012,10,355,870,89,1314,0.2701674277016740,0.2701674277016740
2012-10-26,2012,10,266,794,100,1160,0.2293103448275860,0.2293103448275860
2012-10-27,2012,10,204,682,93,979,0.2083758937691520,0.2083758937691520
2012-10-28,2012,10,145,392,35,572,0.2534965034965040,0.2534965034965040
2012-10-29,2012,10,46,98,5,149,0.3087248322147650,0.3087248322147650
2012-10-30,2012,10,105,166,4,275,0.38181818181818200,0.38181818181818200
2012-10-31,2012,10,145,268,11,424,0.3419811320754720,0.3419811320754720
2012-11-01,2012,11,139,349,16,504,0.2757936507936510,0.2757936507936510
2012-11-02,2012,11,158,281,20,459,0.3442265795206970,0.3442265795206970
2012-11-03,2012,11,130,327,20,477,0.27253668763102700,0.27253668763102700
2012-11-04,2012,11,133,290,15,438,0.3036529680365300,0.3036529680365300
2012-11-05,2012,11,113,282,10,405,0.27901234567901200,0.27901234567901200
2012-11-06,2012,11,166,346,24,536,0.30970149253731300,0.30970149253731300
2012-11-07,2012,11,138,366,12,516,0.26744186046511600,0.26744186046511600
2012-11-08,2012,11,200,467,32,699,0.2861230329041490,0.2861230329041490
2012-11-09,2012,11,199,561,35,795,0.25031446540880500,0.25031446540880500
2012-11-10,2012,11,231,568,35,834,0.27697841726618700,0.27697841726618700
2012-11-11,2012,11,109,376,25,510,0.21372549019607800,0.21372549019607800
2012-11-12,2012,11,146,423,45,614,0.23778501628664500,0.23778501628664500
2012-11-13,2012,11,204,610,48,862,0.23665893271461700,0.23665893271461700
2012-11-14,2012,11,308,722,75,1105,0.27873303167420800,0.27873303167420800
2012-11-15,2012,11,276,797,74,1147,0.24062772449869200,0.24062772449869200
2012-11-16,2012,11,286,733,74,1093,0.2616651418115280,0.2616651418115280
2012-11-17,2012,11,199,615,62,876,0.2271689497716900,0.2271689497716900
2012-11-18,2012,11,130,405,50,585,0.2222222222222220,0.2222222222222220
2012-11-19,2012,11,193,452,41,686,0.2813411078717200,0.2813411078717200
2012-11-20,2012,11,262,730,79,1071,0.2446311858076560,0.2446311858076560
2012-11-21,2012,11,257,622,54,933,0.2754555198285100,0.2754555198285100
2012-11-22,2012,11,92,219,18,329,0.2796352583586630,0.2796352583586630
2012-11-23,2012,11,190,623,44,857,0.22170361726954500,0.22170361726954500
2012-11-24,2012,11,207,549,41,797,0.25972396486825600,0.25972396486825600
2012-11-25,2012,11,118,427,42,587,0.2010221465076660,0.2010221465076660
2012-11-26,2012,11,172,496,42,710,0.24225352112676100,0.24225352112676100
2012-11-27,2012,11,241,633,68,942,0.25583864118896000,0.25583864118896000
2012-11-28,2012,11,316,809,68,1193,0.26487845766974000,0.26487845766974000
2012-11-29,2012,11,315,883,79,1277,0.24667188723570900,0.24667188723570900
2012-11-30,2012,11,275,728,74,1077,0.255338904363974,0.255338904363974
2012-12-01,2012,12,216,651,63,930,0.23225806451612900,0.23225806451612900
2012-12-02,2012,12,152,419,29,600,0.25333333333333300,0.25333333333333300
2012-12-03,2012,12,182,467,50,699,0.2603719599427750,0.2603719599427750
2012-12-04,2012,12,295,822,67,1184,0.2491554054054050,0.2491554054054050
2012-12-05,2012,12,384,867,80,1331,0.28850488354620600,0.28850488354620600
2012-12-06,2012,12,309,815,108,1232,0.2508116883116880,0.2508116883116880
2012-12-07,2012,12,291,805,71,1167,0.2493573264781490,0.2493573264781490
2012-12-08,2012,12,234,689,55,978,0.2392638036809820,0.2392638036809820
2012-12-09,2012,12,150,465,37,652,0.23006134969325200,0.23006134969325200
2012-12-10,2012,12,201,484,48,733,0.2742155525238750,0.2742155525238750
2012-12-11,2012,12,296,830,73,1199,0.2468723936613850,0.2468723936613850
2012-12-12,2012,12,374,831,89,1294,0.2890262751159200,0.2890262751159200
2012-12-13,2012,12,236,773,79,1088,0.21691176470588200,0.21691176470588200
2012-12-14,2012,12,271,776,86,1133,0.23918799646955000,0.23918799646955000
2012-12-15,2012,12,205,696,61,962,0.2130977130977130,0.2130977130977130
2012-12-16,2012,12,114,435,47,596,0.1912751677852350,0.1912751677852350
2012-12-17,2012,12,173,459,39,671,0.2578241430700450,0.2578241430700450
2012-12-18,2012,12,272,720,56,1048,0.2595419847328240,0.2595419847328240
2012-12-19,2012,12,320,789,75,1184,0.2702702702702700,0.2702702702702700
2012-12-20,2012,12,269,711,52,1032,0.2606589147286820,0.2606589147286820
2012-12-21,2012,12,214,607,58,879,0.2434584755403870,0.2434584755403870
2012-12-22,2012,12,172,576,49,797,0.21580928481806800,0.21580928481806800
2012-12-23,2012,12,115,445,29,589,0.19524617996604400,0.19524617996604400
2012-12-24,2012,12,66,205,12,283,0.2332155477031800,0.2332155477031800
2012-12-25,2012,12,63,128,5,196,0.32142857142857100,0.32142857142857100
2012-12-26,2012,12,143,552,47,742,0.192722371967655,0.192722371967655
2012-12-27,2012,12,251,754,64,1069,0.23479887745556600,0.23479887745556600
2012-12-28,2012,12,227,715,50,992,0.2288306451612900,0.2288306451612900
2012-12-29,2012,12,182,566,41,789,0.23067173637515800,0.23067173637515800
2012-12-30,2012,12,145,401,27,573,0.2530541012216410,0.2530541012216410
2012-12-31,2012,12,102,303,17,422,0.24170616113744100,0.24170616113744100
2013-01-01,2013,1,220,584,33,837,0.2628434886499400,0.2628434886499400
2013-01-02,2013,1,296,788,52,1136,0.2605633802816900,0.2605633802816900
2013-01-03,2013,1,341,889,67,1297,0.2629144178874330,0.2629144178874330
2013-01-04,2013,1,334,831,65,1230,0.27154471544715400,0.27154471544715400
2013-01-05,2013,1,253,725,65,1043,0.24256951102588700,0.24256951102588700
2013-01-06,2013,1,166,494,52,712,0.23314606741573000,0.23314606741573000
2013-01-07,2013,1,205,483,68,756,0.27116402116402100,0.27116402116402100
2013-01-08,2013,1,285,851,149,1285,0.22178988326848200,0.22178988326848200
2013-01-09,2013,1,399,1029,160,1588,0.2512594458438290,0.2512594458438290
2013-01-10,2013,1,377,1040,108,1525,0.24721311475409800,0.24721311475409800
2013-01-11,2013,1,314,830,76,1220,0.2573770491803280,0.2573770491803280
2013-01-12,2013,1,258,800,76,1134,0.2275132275132280,0.2275132275132280
2013-01-13,2013,1,135,532,55,722,0.18698060941828300,0.18698060941828300
2013-01-14,2013,1,200,547,55,802,0.24937655860349100,0.24937655860349100
2013-01-15,2013,1,304,791,92,1187,0.2561078348778430,0.2561078348778430
2013-01-16,2013,1,361,719,94,1174,0.3074957410562180,0.3074957410562180
2013-01-17,2013,1,364,925,87,1376,0.26453488372093000,0.26453488372093000
2013-01-18,2013,1,357,841,78,1276,0.2797805642633230,0.2797805642633230
2013-01-19,2013,1,243,767,91,1101,0.22070844686648500,0.22070844686648500
2013-01-20,2013,1,118,518,52,688,0.17151162790697700,0.17151162790697700
2013-01-21,2013,1,164,521,49,734,0.22343324250681200,0.22343324250681200
2013-01-22,2013,1,232,642,48,922,0.25162689804772200,0.25162689804772200
2013-01-23,2013,1,328,744,76,1148,0.2857142857142860,0.2857142857142860
2013-01-24,2013,1,328,833,66,1227,0.267318663406683,0.267318663406683
2013-01-25,2013,1,299,793,72,1164,0.25687285223367700,0.25687285223367700
2013-01-26,2013,1,207,704,65,976,0.21209016393442600,0.21209016393442600
2013-01-27,2013,1,148,501,55,704,0.21022727272727300,0.21022727272727300
2013-01-28,2013,1,186,461,47,694,0.2680115273775220,0.2680115273775220
2013-01-29,2013,1,275,798,74,1147,0.23975588491717500,0.23975588491717500
2013-01-30,2013,1,354,836,96,1286,0.27527216174183500,0.27527216174183500
2013-01-31,2013,1,281,869,58,1208,0.2326158940397350,0.2326158940397350
2013-02-01,2013,2,302,941,57,1300,0.2323076923076920,0.2323076923076920
2013-02-02,2013,2,276,827,90,1193,0.23134953897736800,0.23134953897736800
2013-02-03,2013,2,139,397,41,577,0.24090121317157700,0.24090121317157700
2013-02-04,2013,2,184,501,39,724,0.2541436464088400,0.2541436464088400
2013-02-05,2013,2,372,797,81,1250,0.2976,0.2976
2013-02-06,2013,2,303,802,94,1199,0.2527105921601330,0.2527105921601330
2013-02-07,2013,2,423,1035,115,1573,0.26891290527654200,0.26891290527654200
2013-02-08,2013,2,216,499,50,765,0.2823529411764710,0.2823529411764710
2013-02-09,2013,2,131,453,41,625,0.2096,0.2096
2013-02-10,2013,2,150,515,58,723,0.2074688796680500,0.2074688796680500
2013-02-11,2013,2,179,568,43,790,0.22658227848101300,0.22658227848101300
2013-02-12,2013,2,349,1038,97,1484,0.23517520215633400,0.23517520215633400
2013-02-13,2013,2,387,975,97,1459,0.26525017135024000,0.26525017135024000
2013-02-14,2013,2,280,837,92,1209,0.23159636062861900,0.23159636062861900
2013-02-15,2013,2,335,1031,117,1483,0.22589345920431600,0.22589345920431600
2013-02-16,2013,2,235,829,98,1162,0.20223752151463000,0.20223752151463000
2013-02-17,2013,2,151,553,64,768,0.19661458333333300,0.19661458333333300
2013-02-18,2013,2,195,568,47,810,0.24074074074074100,0.24074074074074100
2013-02-19,2013,2,253,778,67,1098,0.23041894353369800,0.23041894353369800
2013-02-20,2013,2,381,933,96,1410,0.2702127659574470,0.2702127659574470
2013-02-21,2013,2,333,960,98,1391,0.2393961179007910,0.2393961179007910
2013-02-22,2013,2,288,878,103,1269,0.22695035460992900,0.22695035460992900
2013-02-23,2013,2,246,736,94,1076,0.22862453531598500,0.22862453531598500
2013-02-24,2013,2,171,616,62,849,0.20141342756183700,0.20141342756183700
2013-02-25,2013,2,206,611,56,873,0.23596792668957600,0.23596792668957600
2013-02-26,2013,2,293,876,108,1277,0.22944400939702400,0.22944400939702400
2013-02-27,2013,2,356,909,113,1378,0.25834542815674900,0.25834542815674900
2013-02-28,2013,2,434,1008,135,1577,0.27520608750792600,0.27520608750792600
2013-03-01,2013,3,286,887,114,1287,0.2222222222222220,0.2222222222222220
2013-03-02,2013,3,275,826,87,1188,0.23148148148148100,0.23148148148148100
2013-03-03,2013,3,142,561,72,775,0.1832258064516130,0.1832258064516130
2013-03-04,2013,3,201,552,48,801,0.250936329588015,0.250936329588015
2013-03-05,2013,3,370,850,95,1315,0.2813688212927760,0.2813688212927760
2013-03-06,2013,3,345,844,88,1277,0.2701644479248240,0.2701644479248240
2013-03-07,2013,3,292,810,74,1176,0.24829931972789100,0.24829931972789100
2013-03-08,2013,3,318,774,75,1167,0.27249357326478100,0.27249357326478100
2013-03-09,2013,3,243,920,125,1288,0.18866459627329200,0.18866459627329200
2013-03-10,2013,3,160,556,56,772,0.20725388601036300,0.20725388601036300
2013-03-11,2013,3,224,654,76,954,0.2348008385744240,0.2348008385744240
2013-03-12,2013,3,265,730,111,1106,0.23960216998191700,0.23960216998191700
2013-03-13,2013,3,374,1074,117,1565,0.2389776357827480,0.2389776357827480
2013-03-14,2013,3,346,844,83,1273,0.2717989002356640,0.2717989002356640
2013-03-15,2013,3,323,841,93,1257,0.2569610182975340,0.2569610182975340
2013-03-16,2013,3,222,674,65,961,0.23100936524453700,0.23100936524453700
2013-03-17,2013,3,157,561,63,781,0.20102432778489100,0.20102432778489100
2013-03-18,2013,3,197,511,35,743,0.2651413189771200,0.2651413189771200
2013-03-19,2013,3,269,711,63,1043,0.2579098753595400,0.2579098753595400
2013-03-20,2013,3,378,976,118,1472,0.25679347826087000,0.25679347826087000
2013-03-21,2013,3,325,976,95,1396,0.2328080229226360,0.2328080229226360
2013-03-22,2013,3,282,855,76,1213,0.23248145094806300,0.23248145094806300
2013-03-23,2013,3,191,756,88,1035,0.18454106280193200,0.18454106280193200
2013-03-24,2013,3,133,523,68,724,0.18370165745856400,0.18370165745856400
2013-03-25,2013,3,178,501,42,721,0.24687933425797500,0.24687933425797500
2013-03-26,2013,3,305,874,84,1263,0.2414885193982580,0.2414885193982580
2013-03-27,2013,3,336,860,72,1268,0.26498422712933800,0.26498422712933800
2013-03-28,2013,3,288,820,84,1192,0.24161073825503400,0.24161073825503400
2013-03-29,2013,3,251,823,79,1153,0.21769297484822200,0.21769297484822200
2013-03-30,2013,3,231,663,75,969,0.23839009287925700,0.23839009287925700
2013-03-31,2013,3,77,332,31,440,0.175,0.175
2013-04-01,2013,4,177,484,59,720,0.24583333333333300,0.24583333333333300
2013-04-02,2013,4,292,786,83,1161,0.25150732127476300,0.25150732127476300
2013-04-03,2013,4,364,850,105,1319,0.2759666413949960,0.2759666413949960
2013-04-04,2013,4,317,937,128,1382,0.22937771345875500,0.22937771345875500
2013-04-05,2013,4,299,930,115,1344,0.22247023809523800,0.22247023809523800
2013-04-06,2013,4,227,852,98,1177,0.19286321155480000,0.19286321155480000
2013-04-07,2013,4,135,554,89,778,0.17352185089974300,0.17352185089974300
2013-04-08,2013,4,226,603,72,901,0.25083240843507200,0.25083240843507200
2013-04-09,2013,4,314,925,91,1330,0.23609022556391000,0.23609022556391000
2013-04-10,2013,4,423,1001,134,1558,0.27150192554557100,0.27150192554557100
2013-04-11,2013,4,357,863,119,1339,0.2666168782673640,0.2666168782673640
2013-04-12,2013,4,310,798,104,1212,0.25577557755775600,0.25577557755775600
2013-04-13,2013,4,238,846,99,1183,0.20118343195266300,0.20118343195266300
2013-04-14,2013,4,149,508,79,736,0.20244565217391300,0.20244565217391300
2013-04-15,2013,4,190,551,57,798,0.23809523809523800,0.23809523809523800
2013-04-16,2013,4,355,840,83,1278,0.2777777777777780,0.2777777777777780
2013-04-17,2013,4,377,858,109,1344,0.2805059523809520,0.2805059523809520
2013-04-18,2013,4,375,936,88,1399,0.268048606147248,0.268048606147248
2013-04-19,2013,4,326,948,95,1369,0.2381300219138060,0.2381300219138060
2013-04-20,2013,4,227,829,87,1143,0.19860017497812800,0.19860017497812800
2013-04-21,2013,4,151,621,62,834,0.18105515587530000,0.18105515587530000
2013-04-22,2013,4,223,581,54,858,0.25990675990676000,0.25990675990676000
2013-04-23,2013,4,302,808,86,1196,0.2525083612040130,0.2525083612040130
2013-04-24,2013,4,381,991,128,1500,0.254,0.254
2013-04-25,2013,4,312,953,131,1396,0.22349570200573100,0.22349570200573100
2013-04-26,2013,4,283,1001,123,1407,0.20113717128642500,0.20113717128642500
2013-04-27,2013,4,229,917,96,1242,0.18438003220611900,0.18438003220611900
2013-04-28,2013,4,148,529,66,743,0.19919246298788700,0.19919246298788700
2013-04-29,2013,4,218,506,59,783,0.2784163473818650,0.2784163473818650
2013-04-30,2013,4,292,694,75,1061,0.27521206409048100,0.27521206409048100
2013-05-01,2013,5,356,909,91,1356,0.26253687315634200,0.26253687315634200
2013-05-02,2013,5,348,951,100,1399,0.24874910650464600,0.24874910650464600
2013-05-03,2013,5,326,927,101,1354,0.24076809453471200,0.24076809453471200
2013-05-04,2013,5,237,767,103,1107,0.2140921409214090,0.2140921409214090
2013-05-05,2013,5,157,529,73,759,0.20685111989459800,0.20685111989459800
2013-05-06,2013,5,225,636,74,935,0.24064171122994700,0.24064171122994700
2013-05-07,2013,5,355,928,73,1356,0.2617994100294990,0.2617994100294990
2013-05-08,2013,5,376,885,89,1350,0.2785185185185190,0.2785185185185190
2013-05-09,2013,5,390,944,114,1448,0.26933701657458600,0.26933701657458600
2013-05-10,2013,5,303,1005,129,1437,0.21085594989561600,0.21085594989561600
2013-05-11,2013,5,261,751,100,1112,0.23471223021582700,0.23471223021582700
2013-05-12,2013,5,142,485,71,698,0.2034383954154730,0.2034383954154730
2013-05-13,2013,5,211,550,62,823,0.25637910085054700,0.25637910085054700
2013-05-14,2013,5,345,918,85,1348,0.2559347181008900,0.2559347181008900
2013-05-15,2013,5,412,909,119,1440,0.2861111111111110,0.2861111111111110
2013-05-16,2013,5,371,972,109,1452,0.25550964187327800,0.25550964187327800
2013-05-17,2013,5,325,902,109,1336,0.2432634730538920,0.2432634730538920
2013-05-18,2013,5,236,771,79,1086,0.21731123388582000,0.21731123388582000
2013-05-19,2013,5,138,455,60,653,0.2113323124042880,0.2113323124042880
2013-05-20,2013,5,226,629,66,921,0.24538545059717700,0.24538545059717700
2013-05-21,2013,5,354,835,84,1273,0.27808326787117000,0.27808326787117000
2013-05-22,2013,5,358,918,76,1352,0.26479289940828400,0.26479289940828400
2013-05-23,2013,5,322,790,109,1221,0.26371826371826400,0.26371826371826400
2013-05-24,2013,5,258,772,88,1118,0.23076923076923100,0.23076923076923100
2013-05-25,2013,5,231,685,65,981,0.23547400611620800,0.23547400611620800
2013-05-26,2013,5,139,538,72,749,0.1855807743658210,0.1855807743658210
2013-05-27,2013,5,106,505,51,662,0.16012084592145000,0.16012084592145000
2013-05-28,2013,5,260,760,63,1083,0.24007386888273300,0.24007386888273300
2013-05-29,2013,5,405,859,93,1357,0.2984524686809140,0.2984524686809140
2013-05-30,2013,5,281,831,81,1193,0.2355406538139150,0.2355406538139150
2013-05-31,2013,5,246,793,80,1119,0.21983914209115300,0.21983914209115300
2013-06-01,2013,6,211,703,106,1020,0.2068627450980390,0.2068627450980390
2013-06-02,2013,6,137,533,93,763,0.17955439056356500,0.17955439056356500
2013-06-03,2013,6,224,528,52,804,0.27860696517412900,0.27860696517412900
2013-06-04,2013,6,354,896,83,1333,0.26556639159789900,0.26556639159789900
2013-06-05,2013,6,352,947,108,1407,0.2501776830135040,0.2501776830135040
2013-06-06,2013,6,343,856,82,1281,0.2677595628415300,0.2677595628415300
2013-06-07,2013,6,265,579,56,900,0.29444444444444400,0.29444444444444400
2013-06-08,2013,6,224,628,84,936,0.23931623931623900,0.23931623931623900
2013-06-09,2013,6,160,635,88,883,0.1812004530011330,0.1812004530011330
2013-06-10,2013,6,183,476,43,702,0.2606837606837610,0.2606837606837610
2013-06-11,2013,6,350,794,96,1240,0.28225806451612900,0.28225806451612900
2013-06-12,2013,6,347,943,111,1401,0.2476802284082800,0.2476802284082800
2013-06-13,2013,6,249,804,103,1156,0.21539792387543300,0.21539792387543300
2013-06-14,2013,6,333,795,91,1219,0.27317473338802300,0.27317473338802300
2013-06-15,2013,6,248,780,73,1101,0.22524977293369700,0.22524977293369700
2013-06-16,2013,6,139,477,74,690,0.20144927536231900,0.20144927536231900
2013-06-17,2013,6,201,610,62,873,0.23024054982817900,0.23024054982817900
2013-06-18,2013,6,324,739,78,1141,0.2839614373356710,0.2839614373356710
2013-06-19,2013,6,391,906,98,1395,0.2802867383512550,0.2802867383512550
2013-06-20,2013,6,310,921,108,1339,0.2315160567587750,0.2315160567587750
2013-06-21,2013,6,317,860,102,1279,0.24784988272087600,0.24784988272087600
2013-06-22,2013,6,212,703,98,1013,0.20927936821322800,0.20927936821322800
2013-06-23,2013,6,136,489,73,698,0.19484240687679100,0.19484240687679100
2013-06-24,2013,6,194,478,48,720,0.26944444444444400,0.26944444444444400
2013-06-25,2013,6,287,732,90,1109,0.2587917042380520,0.2587917042380520
2013-06-26,2013,6,363,815,87,1265,0.28695652173913000,0.28695652173913000
2013-06-27,2013,6,305,799,102,1206,0.25290215588723100,0.25290215588723100
2013-06-28,2013,6,243,685,77,1005,0.2417910447761190,0.2417910447761190
2013-06-29,2013,6,252,679,87,1018,0.2475442043222000,0.2475442043222000
2013-06-30,2013,6,150,486,55,691,0.2170767004341530,0.2170767004341530
2013-07-01,2013,7,232,509,67,808,0.2871287128712870,0.2871287128712870
2013-07-02,2013,7,366,782,85,1233,0.29683698296837000,0.29683698296837000
2013-07-03,2013,7,337,874,100,1311,0.2570556826849730,0.2570556826849730
2013-07-04,2013,7,184,661,95,940,0.19574468085106400,0.19574468085106400
2013-07-05,2013,7,227,780,113,1120,0.20267857142857100,0.20267857142857100
2013-07-06,2013,7,233,642,92,967,0.24095139607032100,0.24095139607032100
2013-07-07,2013,7,154,504,59,717,0.21478382147838200,0.21478382147838200
2013-07-08,2013,7,209,532,57,798,0.2619047619047620,0.2619047619047620
2013-07-09,2013,7,362,897,84,1343,0.2695457930007450,0.2695457930007450
2013-07-10,2013,7,413,801,111,1325,0.31169811320754700,0.31169811320754700
2013-07-11,2013,7,344,868,114,1326,0.2594268476621420,0.2594268476621420
2013-07-12,2013,7,296,752,96,1144,0.25874125874125900,0.25874125874125900
2013-07-13,2013,7,236,687,91,1014,0.23274161735700200,0.23274161735700200
2013-07-14,2013,7,145,516,77,738,0.19647696476964800,0.19647696476964800
2013-07-15,2013,7,187,460,43,690,0.2710144927536230,0.2710144927536230
2013-07-16,2013,7,382,763,77,1222,0.31260229132569600,0.31260229132569600
2013-07-17,2013,7,359,834,109,1302,0.27572964669738900,0.27572964669738900
2013-07-18,2013,7,357,856,114,1327,0.2690278824415980,0.2690278824415980
2013-07-19,2013,7,299,739,111,1149,0.26022628372497800,0.26022628372497800
2013-07-20,2013,7,261,702,83,1046,0.24952198852772500,0.24952198852772500
2013-07-21,2013,7,152,529,86,767,0.1981747066492830,0.1981747066492830
2013-07-22,2013,7,233,591,64,888,0.26238738738738700,0.26238738738738700
2013-07-23,2013,7,286,777,83,1146,0.24956369982548000,0.24956369982548000
2013-07-24,2013,7,403,911,114,1428,0.2822128851540620,0.2822128851540620
2013-07-25,2013,7,358,836,99,1293,0.2768754833720030,0.2768754833720030
2013-07-26,2013,7,309,779,101,1189,0.25988225399495400,0.25988225399495400
2013-07-27,2013,7,233,740,109,1082,0.21534195933456600,0.21534195933456600
2013-07-28,2013,7,164,517,81,762,0.2152230971128610,0.2152230971128610
2013-07-29,2013,7,195,522,62,779,0.2503209242618740,0.2503209242618740
2013-07-30,2013,7,286,733,89,1108,0.2581227436823110,0.2581227436823110
2013-07-31,2013,7,308,864,92,1264,0.24367088607594900,0.24367088607594900
2013-08-01,2013,8,305,830,100,1235,0.24696356275303600,0.24696356275303600
2013-08-02,2013,8,337,915,126,1378,0.24455732946299000,0.24455732946299000
2013-08-03,2013,8,248,843,111,1202,0.20632279534109800,0.20632279534109800
2013-08-04,2013,8,166,619,94,879,0.18885096700796400,0.18885096700796400
2013-08-05,2013,8,239,552,71,862,0.27726218097447800,0.27726218097447800
2013-08-06,2013,8,305,790,92,1187,0.2569502948609940,0.2569502948609940
2013-08-07,2013,8,353,907,101,1361,0.25936811168258600,0.25936811168258600
2013-08-08,2013,8,392,776,105,1273,0.3079340141398270,0.3079340141398270
2013-08-09,2013,8,287,808,123,1218,0.23563218390804600,0.23563218390804600
2013-08-10,2013,8,226,751,118,1095,0.20639269406392700,0.20639269406392700
2013-08-11,2013,8,164,593,84,841,0.19500594530321000,0.19500594530321000
2013-08-12,2013,8,194,575,64,833,0.23289315726290500,0.23289315726290500
2013-08-13,2013,8,320,802,97,1219,0.26251025430680900,0.26251025430680900
2013-08-14,2013,8,442,938,102,1482,0.2982456140350880,0.2982456140350880
2013-08-15,2013,8,349,866,116,1331,0.2622088655146510,0.2622088655146510
2013-08-16,2013,8,277,875,134,1286,0.21539657853810300,0.21539657853810300
2013-08-17,2013,8,202,736,90,1028,0.19649805447470800,0.19649805447470800
2013-08-18,2013,8,165,522,66,753,0.21912350597609600,0.21912350597609600
2013-08-19,2013,8,209,547,71,827,0.25272067714631200,0.25272067714631200
2013-08-20,2013,8,295,784,113,1192,0.24748322147651000,0.24748322147651000
2013-08-21,2013,8,302,935,94,1331,0.22689706987227600,0.22689706987227600
2013-08-22,2013,8,284,733,87,1104,0.2572463768115940,0.2572463768115940
2013-08-23,2013,8,315,805,123,1243,0.25341914722445700,0.25341914722445700
2013-08-24,2013,8,226,707,82,1015,0.22266009852216700,0.22266009852216700
2013-08-25,2013,8,146,512,69,727,0.20082530949105900,0.20082530949105900
2013-08-26,2013,8,187,455,60,702,0.26638176638176600,0.26638176638176600
2013-08-27,2013,8,301,779,87,1167,0.2579263067694940,0.2579263067694940
2013-08-28,2013,8,314,805,116,1235,0.25425101214574900,0.25425101214574900
2013-08-29,2013,8,268,763,109,1140,0.23508771929824600,0.23508771929824600
2013-08-30,2013,8,299,717,107,1123,0.26625111308993800,0.26625111308993800
2013-08-31,2013,8,190,661,92,943,0.2014846235418880,0.2014846235418880
2013-09-01,2013,9,160,472,57,689,0.23222060957910000,0.23222060957910000
2013-09-02,2013,9,139,427,53,619,0.2245557350565430,0.2245557350565430
2013-09-03,2013,9,297,699,82,1078,0.2755102040816330,0.2755102040816330
2013-09-04,2013,9,302,871,90,1263,0.2391132224861440,0.2391132224861440
2013-09-05,2013,9,337,852,99,1288,0.26164596273291900,0.26164596273291900
2013-09-06,2013,9,313,836,106,1255,0.24940239043824700,0.24940239043824700
2013-09-07,2013,9,223,824,94,1141,0.19544259421560000,0.19544259421560000
2013-09-08,2013,9,166,540,64,770,0.21558441558441600,0.21558441558441600
2013-09-09,2013,9,173,574,44,791,0.21871049304677600,0.21871049304677600
2013-09-10,2013,9,233,599,75,907,0.25689084895259100,0.25689084895259100
2013-09-11,2013,9,326,809,109,1244,0.2620578778135050,0.2620578778135050
2013-09-12,2013,9,307,800,106,1213,0.25309150865622400,0.25309150865622400
2013-09-13,2013,9,298,822,96,1216,0.2450657894736840,0.2450657894736840
2013-09-14,2013,9,233,728,90,1051,0.22169362511893400,0.22169362511893400
2013-09-15,2013,9,144,536,47,727,0.19807427785419500,0.19807427785419500
2013-09-16,2013,9,209,565,55,829,0.25211097708082000,0.25211097708082000
2013-09-17,2013,9,279,716,88,1083,0.25761772853185600,0.25761772853185600
2013-09-18,2013,9,377,918,98,1393,0.2706389088298640,0.2706389088298640
2013-09-19,2013,9,353,908,131,1392,0.2535919540229890,0.2535919540229890
2013-09-20,2013,9,362,855,139,1356,0.2669616519174040,0.2669616519174040
2013-09-21,2013,9,225,722,84,1031,0.21823472356935000,0.21823472356935000
2013-09-22,2013,9,132,482,46,660,0.2,0.2
2013-09-23,2013,9,208,547,51,806,0.25806451612903200,0.25806451612903200
2013-09-24,2013,9,254,737,82,1073,0.23671947809878800,0.23671947809878800
2013-09-25,2013,9,308,851,94,1253,0.24581005586592200,0.24581005586592200
2013-09-26,2013,9,332,856,82,1270,0.2614173228346460,0.2614173228346460
2013-09-27,2013,9,252,772,116,1140,0.22105263157894700,0.22105263157894700
2013-09-28,2013,9,185,775,87,1047,0.1766953199617960,0.1766953199617960
2013-09-29,2013,9,144,528,49,721,0.19972260748959800,0.19972260748959800
2013-09-30,2013,9,178,483,52,713,0.2496493688639550,0.2496493688639550
2013-10-01,2013,10,274,698,89,1061,0.2582469368520260,0.2582469368520260
2013-10-02,2013,10,380,941,103,1424,0.26685393258427000,0.26685393258427000
2013-10-03,2013,10,325,976,125,1426,0.22791023842917300,0.22791023842917300
2013-10-04,2013,10,347,898,147,1392,0.2492816091954020,0.2492816091954020
2013-10-05,2013,10,271,739,95,1105,0.24524886877828100,0.24524886877828100
2013-10-06,2013,10,152,522,71,745,0.2040268456375840,0.2040268456375840
2013-10-07,2013,10,229,543,54,826,0.2772397094430990,0.2772397094430990
2013-10-08,2013,10,391,850,96,1337,0.2924457741211670,0.2924457741211670
2013-10-09,2013,10,383,879,119,1381,0.277335264301231,0.277335264301231
2013-10-10,2013,10,325,850,95,1270,0.2559055118110240,0.2559055118110240
2013-10-11,2013,10,341,805,109,1255,0.27171314741035900,0.27171314741035900
2013-10-12,2013,10,253,756,90,1099,0.2302092811646950,0.2302092811646950
2013-10-13,2013,10,142,560,74,776,0.18298969072164900,0.18298969072164900
2013-10-14,2013,10,165,516,67,748,0.22058823529411800,0.22058823529411800
2013-10-15,2013,10,312,762,74,1148,0.27177700348432100,0.27177700348432100
2013-10-16,2013,10,300,863,79,1242,0.24154589371980700,0.24154589371980700
2013-10-17,2013,10,393,807,87,1287,0.30536130536130500,0.30536130536130500
2013-10-18,2013,10,238,670,68,976,0.24385245901639300,0.24385245901639300
2013-10-19,2013,10,158,509,49,716,0.2206703910614530,0.2206703910614530
2013-10-20,2013,10,140,506,54,700,0.2,0.2
2013-10-21,2013,10,242,516,61,819,0.2954822954822960,0.2954822954822960
2013-10-22,2013,10,299,847,92,1238,0.24151857835218100,0.24151857835218100
2013-10-23,2013,10,367,864,93,1324,0.277190332326284,0.277190332326284
2013-10-24,2013,10,295,871,80,1246,0.23675762439807400,0.23675762439807400
2013-10-25,2013,10,279,750,85,1114,0.2504488330341110,0.2504488330341110
2013-10-26,2013,10,220,723,61,1004,0.21912350597609600,0.21912350597609600
2013-10-27,2013,10,149,514,59,722,0.20637119113573400,0.20637119113573400
2013-10-28,2013,10,226,539,53,818,0.2762836185819070,0.2762836185819070
2013-10-29,2013,10,262,760,82,1104,0.23731884057971000,0.23731884057971000
2013-10-30,2013,10,361,828,83,1272,0.2838050314465410,0.2838050314465410
2013-10-31,2013,10,225,619,62,906,0.24834437086092700,0.24834437086092700
2013-11-01,2013,11,335,796,120,1251,0.26778577138289400,0.26778577138289400
2013-11-02,2013,11,258,745,90,1093,0.23604757548032900,0.23604757548032900
2013-11-03,2013,11,123,440,39,602,0.20431893687707600,0.20431893687707600
2013-11-04,2013,11,221,493,53,767,0.288135593220339,0.288135593220339
2013-11-05,2013,11,257,648,71,976,0.26331967213114800,0.26331967213114800
2013-11-06,2013,11,324,892,98,1314,0.2465753424657530,0.2465753424657530
2013-11-07,2013,11,325,844,120,1289,0.252133436772692,0.252133436772692
2013-11-08,2013,11,335,905,106,1346,0.24888558692422000,0.24888558692422000
2013-11-09,2013,11,225,892,104,1221,0.18427518427518400,0.18427518427518400
2013-11-10,2013,11,163,563,57,783,0.2081736909323120,0.2081736909323120
2013-11-11,2013,11,191,554,51,796,0.2399497487437190,0.2399497487437190
2013-11-12,2013,11,288,809,69,1166,0.2469982847341340,0.2469982847341340
2013-11-13,2013,11,336,851,66,1253,0.2681564245810060,0.2681564245810060
2013-11-14,2013,11,346,863,77,1286,0.2690513219284600,0.2690513219284600
2013-11-15,2013,11,334,891,107,1332,0.25075075075075100,0.25075075075075100
2013-11-16,2013,11,312,777,89,1178,0.26485568760611200,0.26485568760611200
2013-11-17,2013,11,157,530,60,747,0.2101740294511380,0.2101740294511380
2013-11-18,2013,11,248,523,45,816,0.30392156862745100,0.30392156862745100
2013-11-19,2013,11,339,747,138,1224,0.2769607843137260,0.2769607843137260
2013-11-20,2013,11,361,880,81,1322,0.273071104387292,0.273071104387292
2013-11-21,2013,11,334,880,90,1304,0.2561349693251530,0.2561349693251530
2013-11-22,2013,11,328,907,128,1363,0.24064563462949400,0.24064563462949400
2013-11-23,2013,11,258,772,83,1113,0.23180592991913700,0.23180592991913700
2013-11-24,2013,11,118,489,44,651,0.18125960061443900,0.18125960061443900
2013-11-25,2013,11,207,523,44,774,0.26744186046511600,0.26744186046511600
2013-11-26,2013,11,238,714,79,1031,0.23084384093113500,0.23084384093113500
2013-11-27,2013,11,231,506,63,800,0.28875,0.28875
2013-11-28,2013,11,79,248,19,346,0.22832369942196500,0.22832369942196500
2013-11-29,2013,11,213,723,65,1001,0.2127872127872130,0.2127872127872130
2013-11-30,2013,11,210,694,51,955,0.2198952879581150,0.2198952879581150
2013-12-01,2013,12,152,524,51,727,0.20907840440165100,0.20907840440165100
2013-12-02,2013,12,231,523,44,798,0.2894736842105260,0.2894736842105260
2013-12-03,2013,12,299,801,88,1188,0.2516835016835020,0.2516835016835020
2013-12-04,2013,12,309,861,114,1284,0.24065420560747700,0.24065420560747700
2013-12-05,2013,12,291,856,98,1245,0.23373493975903600,0.23373493975903600
2013-12-06,2013,12,263,749,81,1093,0.24062214089661500,0.24062214089661500
2013-12-07,2013,12,213,731,81,1025,0.20780487804878000,0.20780487804878000
2013-12-08,2013,12,153,517,48,718,0.21309192200557100,0.21309192200557100
2013-12-09,2013,12,233,530,43,806,0.2890818858560790,0.2890818858560790
2013-12-10,2013,12,300,671,57,1028,0.2918287937743190,0.2918287937743190
2013-12-11,2013,12,332,836,99,1267,0.26203630623520100,0.26203630623520100
2013-12-12,2013,12,302,741,73,1116,0.27060931899641600,0.27060931899641600
2013-12-13,2013,12,235,789,86,1110,0.21171171171171200,0.21171171171171200
2013-12-14,2013,12,168,524,61,753,0.22310756972111600,0.22310756972111600
2013-12-15,2013,12,108,414,36,558,0.1935483870967740,0.1935483870967740
2013-12-16,2013,12,193,471,39,703,0.27453769559032700,0.27453769559032700
2013-12-17,2013,12,249,560,61,870,0.28620689655172400,0.28620689655172400
2013-12-18,2013,12,334,890,74,1298,0.2573189522342070,0.2573189522342070
2013-12-19,2013,12,283,743,74,1100,0.25727272727272700,0.25727272727272700
2013-12-20,2013,12,266,740,87,1093,0.2433668801463860,0.2433668801463860
2013-12-21,2013,12,211,737,86,1034,0.20406189555125700,0.20406189555125700
2013-12-22,2013,12,152,543,52,747,0.2034805890227580,0.2034805890227580
2013-12-23,2013,12,159,436,39,634,0.250788643533123,0.250788643533123
2013-12-24,2013,12,108,314,14,436,0.24770642201834900,0.24770642201834900
2013-12-25,2013,12,75,189,5,269,0.2788104089219330,0.2788104089219330
2013-12-26,2013,12,261,738,58,1057,0.2469252601702930,0.2469252601702930
2013-12-27,2013,12,274,815,71,1160,0.23620689655172400,0.23620689655172400
2013-12-28,2013,12,212,732,54,998,0.2124248496993990,0.2124248496993990
2013-12-29,2013,12,129,492,25,646,0.1996904024767800,0.1996904024767800
2013-12-30,2013,12,170,471,24,665,0.2556390977443610,0.2556390977443610
2013-12-31,2013,12,102,339,28,469,0.21748400852878500,0.21748400852878500
2014-01-01,2014,1,245,703,49,997,0.24573721163490500,0.24573721163490500
2014-01-02,2014,1,256,715,73,1044,0.24521072796934900,0.24521072796934900
2014-01-03,2014,1,134,431,86,651,0.20583717357910900,0.20583717357910900
2014-01-04,2014,1,237,600,101,938,0.2526652452025590,0.2526652452025590
2014-01-05,2014,1,107,461,58,626,0.17092651757188500,0.17092651757188500
2014-01-06,2014,1,205,528,36,769,0.2665799739921980,0.2665799739921980
2014-01-07,2014,1,351,608,63,1022,0.34344422700587100,0.34344422700587100
2014-01-08,2014,1,373,833,82,1288,0.28959627329192500,0.28959627329192500
2014-01-09,2014,1,362,837,143,1342,0.2697466467958270,0.2697466467958270
2014-01-10,2014,1,293,916,115,1324,0.2212990936555890,0.2212990936555890
2014-01-11,2014,1,239,725,109,1073,0.22273998136067100,0.22273998136067100
2014-01-12,2014,1,151,603,76,830,0.1819277108433740,0.1819277108433740
2014-01-13,2014,1,268,640,50,958,0.2797494780793320,0.2797494780793320
2014-01-14,2014,1,331,829,79,1239,0.26715092816787700,0.26715092816787700
2014-01-15,2014,1,430,957,93,1480,0.2905405405405410,0.2905405405405410
2014-01-16,2014,1,356,958,90,1404,0.2535612535612540,0.2535612535612540
2014-01-17,2014,1,332,922,127,1381,0.24040550325850800,0.24040550325850800
2014-01-18,2014,1,262,860,85,1207,0.21706710853355400,0.21706710853355400
2014-01-19,2014,1,162,587,54,803,0.20174346201743500,0.20174346201743500
2014-01-20,2014,1,202,616,68,886,0.22799097065462800,0.22799097065462800
2014-01-21,2014,1,205,377,32,614,0.3338762214983710,0.3338762214983710
2014-01-22,2014,1,222,635,60,917,0.2420937840785170,0.2420937840785170
2014-01-23,2014,1,357,779,96,1232,0.2897727272727270,0.2897727272727270
2014-01-24,2014,1,267,856,72,1195,0.22343096234309600,0.22343096234309600
2014-01-25,2014,1,190,823,88,1101,0.17257039055404200,0.17257039055404200
2014-01-26,2014,1,152,617,48,817,0.18604651162790700,0.18604651162790700
2014-01-27,2014,1,241,514,43,798,0.30200501253132800,0.30200501253132800
2014-01-28,2014,1,262,757,53,1072,0.24440298507462700,0.24440298507462700
2014-01-29,2014,1,322,844,60,1226,0.2626427406199020,0.2626427406199020
2014-01-30,2014,1,263,790,76,1129,0.2329495128432240,0.2329495128432240
2014-01-31,2014,1,290,795,101,1186,0.24451939291736900,0.24451939291736900
2014-02-01,2014,2,240,889,86,1215,0.19753086419753100,0.19753086419753100
2014-02-02,2014,2,144,547,65,756,0.19047619047619000,0.19047619047619000
2014-02-03,2014,2,164,438,41,643,0.25505443234836700,0.25505443234836700
2014-02-04,2014,2,328,809,67,1204,0.2724252491694350,0.2724252491694350
2014-02-05,2014,2,288,702,76,1066,0.2701688555347090,0.2701688555347090
2014-02-06,2014,2,324,997,111,1432,0.22625698324022300,0.22625698324022300
2014-02-07,2014,2,308,884,100,1292,0.23839009287925700,0.23839009287925700
2014-02-08,2014,2,234,842,80,1156,0.20242214532872000,0.20242214532872000
2014-02-09,2014,2,138,606,47,791,0.17446270543615700,0.17446270543615700
2014-02-10,2014,2,185,548,49,782,0.23657289002557500,0.23657289002557500
2014-02-11,2014,2,352,831,67,1250,0.2816,0.2816
2014-02-12,2014,2,305,999,126,1430,0.21328671328671300,0.21328671328671300
2014-02-13,2014,2,140,425,38,603,0.23217247097844100,0.23217247097844100
2014-02-14,2014,2,217,755,81,1053,0.2060778727445390,0.2060778727445390
2014-02-15,2014,2,246,812,83,1141,0.21560035056967600,0.21560035056967600
2014-02-16,2014,2,170,524,67,761,0.2233902759526940,0.2233902759526940
2014-02-17,2014,2,154,573,48,775,0.19870967741935500,0.19870967741935500
2014-02-18,2014,2,299,836,73,1208,0.24751655629139100,0.24751655629139100
2014-02-19,2014,2,342,936,117,1395,0.24516129032258100,0.24516129032258100
2014-02-20,2014,2,331,1025,99,1455,0.2274914089347080,0.2274914089347080
2014-02-21,2014,2,277,847,109,1233,0.22465531224655300,0.22465531224655300
2014-02-22,2014,2,283,970,97,1350,0.20962962962963000,0.20962962962963000
2014-02-23,2014,2,145,620,68,833,0.17406962785114000,0.17406962785114000
2014-02-24,2014,2,227,628,63,918,0.24727668845315900,0.24727668845315900
2014-02-25,2014,2,347,872,79,1298,0.26733436055470000,0.26733436055470000
2014-02-26,2014,2,305,828,87,1220,0.25,0.25
2014-02-27,2014,2,277,794,66,1137,0.2436235708003520,0.2436235708003520
2014-02-28,2014,2,299,816,69,1184,0.25253378378378400,0.25253378378378400
2014-03-01,2014,3,229,847,91,1167,0.19622964867180800,0.19622964867180800
2014-03-02,2014,3,139,619,66,824,0.16868932038835000,0.16868932038835000
2014-03-03,2014,3,239,530,42,811,0.29469790382244100,0.29469790382244100
2014-03-04,2014,3,349,871,60,1280,0.27265625,0.27265625
2014-03-05,2014,3,360,1001,88,1449,0.2484472049689440,0.2484472049689440
2014-03-06,2014,3,341,1045,116,1502,0.2270306258322240,0.2270306258322240
2014-03-07,2014,3,320,994,117,1431,0.2236198462613560,0.2236198462613560
2014-03-08,2014,3,319,988,103,1410,0.22624113475177300,0.22624113475177300
2014-03-09,2014,3,147,554,66,767,0.19165580182529300,0.19165580182529300
2014-03-10,2014,3,213,636,86,935,0.22780748663101600,0.22780748663101600
2014-03-11,2014,3,293,853,98,1244,0.23553054662379400,0.23553054662379400
2014-03-12,2014,3,371,907,126,1404,0.26424501424501400,0.26424501424501400
2014-03-13,2014,3,268,893,120,1281,0.20921155347384900,0.20921155347384900
2014-03-14,2014,3,309,1016,97,1422,0.21729957805907200,0.21729957805907200
2014-03-15,2014,3,262,980,98,1340,0.19552238805970100,0.19552238805970100
2014-03-16,2014,3,148,604,51,803,0.1843088418430880,0.1843088418430880
2014-03-17,2014,3,183,588,49,820,0.22317073170731700,0.22317073170731700
2014-03-18,2014,3,278,917,95,1290,0.21550387596899200,0.21550387596899200
2014-03-19,2014,3,338,881,86,1305,0.2590038314176250,0.2590038314176250
2014-03-20,2014,3,315,1032,148,1495,0.21070234113712400,0.21070234113712400
2014-03-21,2014,3,340,1009,118,1467,0.23176550783912700,0.23176550783912700
2014-03-22,2014,3,239,969,109,1317,0.18147304479878500,0.18147304479878500
2014-03-23,2014,3,158,558,54,770,0.2051948051948050,0.2051948051948050
2014-03-24,2014,3,239,549,43,831,0.28760529482551100,0.28760529482551100
2014-03-25,2014,3,316,861,80,1257,0.25139220365950700,0.25139220365950700
2014-03-26,2014,3,310,897,83,1290,0.24031007751938000,0.24031007751938000
2014-03-27,2014,3,348,874,122,1344,0.25892857142857100,0.25892857142857100
2014-03-28,2014,3,339,913,97,1349,0.251297257227576,0.251297257227576
2014-03-29,2014,3,153,650,72,875,0.17485714285714300,0.17485714285714300
2014-03-30,2014,3,133,491,46,670,0.19850746268656700,0.19850746268656700
2014-03-31,2014,3,149,558,56,763,0.19528178243774600,0.19528178243774600
2014-04-01,2014,4,379,910,97,1386,0.27344877344877300,0.27344877344877300
2014-04-02,2014,4,385,964,125,1474,0.26119402985074600,0.26119402985074600
2014-04-03,2014,4,331,946,162,1439,0.23002084781098000,0.23002084781098000
2014-04-04,2014,4,338,924,114,1376,0.24563953488372100,0.24563953488372100
2014-04-05,2014,4,275,865,97,1237,0.2223120452708170,0.2223120452708170
2014-04-06,2014,4,179,577,71,827,0.21644498186215200,0.21644498186215200
2014-04-07,2014,4,219,560,59,838,0.2613365155131270,0.2613365155131270
2014-04-08,2014,4,356,840,114,1310,0.2717557251908400,0.2717557251908400
2014-04-09,2014,4,334,999,90,1423,0.23471539002108200,0.23471539002108200
2014-04-10,2014,4,348,997,163,1508,0.23076923076923100,0.23076923076923100
2014-04-11,2014,4,278,990,124,1392,0.1997126436781610,0.1997126436781610
2014-04-12,2014,4,246,819,85,1150,0.21391304347826100,0.21391304347826100
2014-04-13,2014,4,165,592,83,840,0.19642857142857100,0.19642857142857100
2014-04-14,2014,4,150,453,47,650,0.23076923076923100,0.23076923076923100
2014-04-15,2014,4,257,697,89,1043,0.2464046021093000,0.2464046021093000
2014-04-16,2014,4,357,984,86,1427,0.2501751927119830,0.2501751927119830
2014-04-17,2014,4,300,921,122,1343,0.22338049143708100,0.22338049143708100
2014-04-18,2014,4,295,977,98,1370,0.21532846715328500,0.21532846715328500
2014-04-19,2014,4,189,823,98,1110,0.17027027027027000,0.17027027027027000
2014-04-20,2014,4,116,446,48,610,0.1901639344262300,0.1901639344262300
2014-04-21,2014,4,227,592,61,880,0.25795454545454500,0.25795454545454500
2014-04-22,2014,4,291,821,98,1210,0.24049586776859500,0.24049586776859500
2014-04-23,2014,4,333,992,117,1442,0.23092926490984700,0.23092926490984700
2014-04-24,2014,4,315,867,118,1300,0.2423076923076920,0.2423076923076920
2014-04-25,2014,4,285,930,109,1324,0.21525679758308200,0.21525679758308200
2014-04-26,2014,4,210,719,80,1009,0.20812685827552000,0.20812685827552000
2014-04-27,2014,4,132,637,52,821,0.1607795371498170,0.1607795371498170
2014-04-28,2014,4,208,565,65,838,0.24821002386634800,0.24821002386634800
2014-04-29,2014,4,244,696,55,995,0.24522613065326600,0.24522613065326600
2014-04-30,2014,4,203,510,74,787,0.2579415501905970,0.2579415501905970
2014-05-01,2014,5,378,893,128,1399,0.270192994996426,0.270192994996426
2014-05-02,2014,5,369,1011,111,1491,0.24748490945674000,0.24748490945674000
2014-05-03,2014,5,215,777,84,1076,0.19981412639405200,0.19981412639405200
2014-05-04,2014,5,160,496,65,721,0.22191400832177500,0.22191400832177500
2014-05-05,2014,5,219,560,91,870,0.2517241379310350,0.2517241379310350
2014-05-06,2014,5,361,919,119,1399,0.2580414581844170,0.2580414581844170
2014-05-07,2014,5,360,1059,137,1556,0.23136246786632400,0.23136246786632400
2014-05-08,2014,5,338,893,128,1359,0.2487122884473880,0.2487122884473880
2014-05-09,2014,5,340,914,124,1378,0.2467343976777940,0.2467343976777940
2014-05-10,2014,5,283,759,127,1169,0.24208725406330200,0.24208725406330200
2014-05-11,2014,5,135,507,68,710,0.19014084507042300,0.19014084507042300
2014-05-12,2014,5,228,567,84,879,0.2593856655290100,0.2593856655290100
2014-05-13,2014,5,327,875,129,1331,0.24567993989481600,0.24567993989481600
2014-05-14,2014,5,338,946,111,1395,0.24229390681003600,0.24229390681003600
2014-05-15,2014,5,377,980,114,1471,0.256288239292998,0.256288239292998
2014-05-16,2014,5,269,856,114,1239,0.21711057304277600,0.21711057304277600
2014-05-17,2014,5,232,741,89,1062,0.2184557438794730,0.2184557438794730
2014-05-18,2014,5,174,579,74,827,0.21039903264812600,0.21039903264812600
2014-05-19,2014,5,229,603,68,900,0.2544444444444440,0.2544444444444440
2014-05-20,2014,5,308,873,104,1285,0.2396887159533070,0.2396887159533070
2014-05-21,2014,5,402,934,117,1453,0.276668960770819,0.276668960770819
2014-05-22,2014,5,367,889,102,1358,0.2702503681885130,0.2702503681885130
2014-05-23,2014,5,279,837,104,1220,0.22868852459016400,0.22868852459016400
2014-05-24,2014,5,214,729,80,1023,0.20918866080156400,0.20918866080156400
2014-05-25,2014,5,152,504,79,735,0.20680272108843500,0.20680272108843500
2014-05-26,2014,5,140,456,56,652,0.2147239263803680,0.2147239263803680
2014-05-27,2014,5,258,758,89,1105,0.2334841628959280,0.2334841628959280
2014-05-28,2014,5,379,799,93,1271,0.2981904012588510,0.2981904012588510
2014-05-29,2014,5,352,846,88,1286,0.2737169517884910,0.2737169517884910
2014-05-30,2014,5,316,847,111,1274,0.24803767660910500,0.24803767660910500
2014-05-31,2014,5,232,692,94,1018,0.22789783889980400,0.22789783889980400
2014-06-01,2014,6,134,516,81,731,0.18331053351573200,0.18331053351573200
2014-06-02,2014,6,233,564,51,848,0.27476415094339600,0.27476415094339600
2014-06-03,2014,6,348,800,87,1235,0.2817813765182190,0.2817813765182190
2014-06-04,2014,6,430,947,136,1513,0.28420356906807700,0.28420356906807700
2014-06-05,2014,6,338,880,114,1332,0.25375375375375400,0.25375375375375400
2014-06-06,2014,6,354,856,119,1329,0.26636568848758500,0.26636568848758500
2014-06-07,2014,6,214,766,116,1096,0.19525547445255500,0.19525547445255500
2014-06-08,2014,6,207,544,79,830,0.2493975903614460,0.2493975903614460
2014-06-09,2014,6,228,481,72,781,0.2919334186939820,0.2919334186939820
2014-06-10,2014,6,398,801,98,1297,0.30686198920586000,0.30686198920586000
2014-06-11,2014,6,431,962,105,1498,0.287716955941255,0.287716955941255
2014-06-12,2014,6,314,962,109,1385,0.22671480144404300,0.22671480144404300
2014-06-13,2014,6,329,862,88,1279,0.25723221266614500,0.25723221266614500
2014-06-14,2014,6,248,793,128,1169,0.21214713430282300,0.21214713430282300
2014-06-15,2014,6,133,472,71,676,0.19674556213017800,0.19674556213017800
2014-06-16,2014,6,242,559,63,864,0.2800925925925930,0.2800925925925930
2014-06-17,2014,6,306,716,97,1119,0.2734584450402150,0.2734584450402150
2014-06-18,2014,6,378,943,94,1415,0.26713780918727900,0.26713780918727900
2014-06-19,2014,6,359,860,154,1373,0.2614712308812820,0.2614712308812820
2014-06-20,2014,6,296,870,118,1284,0.23052959501557600,0.23052959501557600
2014-06-21,2014,6,194,763,97,1054,0.1840607210626190,0.1840607210626190
2014-06-22,2014,6,168,547,63,778,0.2159383033419020,0.2159383033419020
2014-06-23,2014,6,221,552,68,841,0.262782401902497,0.262782401902497
2014-06-24,2014,6,336,771,63,1170,0.28717948717948700,0.28717948717948700
2014-06-25,2014,6,363,879,97,1339,0.2710978342046300,0.2710978342046300
2014-06-26,2014,6,281,787,99,1167,0.24078834618680400,0.24078834618680400
2014-06-27,2014,6,266,808,111,1185,0.22447257383966200,0.22447257383966200
2014-06-28,2014,6,189,689,88,966,0.1956521739130440,0.1956521739130440
2014-06-29,2014,6,114,548,70,732,0.1557377049180330,0.1557377049180330
2014-06-30,2014,6,185,463,59,707,0.26166902404526200,0.26166902404526200
2014-07-01,2014,7,356,760,101,1217,0.29252259654889100,0.29252259654889100
2014-07-02,2014,7,375,904,95,1374,0.27292576419214000,0.27292576419214000
2014-07-03,2014,7,303,817,126,1246,0.24317817014446200,0.24317817014446200
2014-07-04,2014,7,176,672,75,923,0.19068255687974000,0.19068255687974000
2014-07-05,2014,7,275,776,107,1158,0.2374784110535410,0.2374784110535410
2014-07-06,2014,7,143,522,85,750,0.19066666666666700,0.19066666666666700
2014-07-07,2014,7,245,520,65,830,0.29518072289156600,0.29518072289156600
2014-07-08,2014,7,329,743,107,1179,0.27905004240882100,0.27905004240882100
2014-07-09,2014,7,391,899,131,1421,0.27515833919774800,0.27515833919774800
2014-07-10,2014,7,402,968,107,1477,0.27217332430602600,0.27217332430602600
2014-07-11,2014,7,291,790,89,1170,0.24871794871794900,0.24871794871794900
2014-07-12,2014,7,224,702,106,1032,0.21705426356589100,0.21705426356589100
2014-07-13,2014,7,160,546,65,771,0.20752269779507100,0.20752269779507100
2014-07-14,2014,7,266,541,67,874,0.30434782608695700,0.30434782608695700
2014-07-15,2014,7,324,657,67,1048,0.30916030534351100,0.30916030534351100
2014-07-16,2014,7,430,962,116,1508,0.28514588859416400,0.28514588859416400
2014-07-17,2014,7,345,781,107,1233,0.2798053527980540,0.2798053527980540
2014-07-18,2014,7,325,836,115,1276,0.2547021943573670,0.2547021943573670
2014-07-19,2014,7,228,782,117,1127,0.2023070097604260,0.2023070097604260
2014-07-20,2014,7,201,584,106,891,0.2255892255892260,0.2255892255892260
2014-07-21,2014,7,216,588,62,866,0.24942263279445700,0.24942263279445700
2014-07-22,2014,7,327,761,87,1175,0.2782978723404260,0.2782978723404260
2014-07-23,2014,7,334,865,97,1296,0.25771604938271600,0.25771604938271600
2014-07-24,2014,7,314,809,95,1218,0.25779967159277500,0.25779967159277500
2014-07-25,2014,7,257,864,113,1234,0.20826580226904400,0.20826580226904400
2014-07-26,2014,7,229,755,97,1081,0.211840888066605,0.211840888066605
2014-07-27,2014,7,174,627,81,882,0.19727891156462600,0.19727891156462600
2014-07-28,2014,7,200,525,62,787,0.25412960609911100,0.25412960609911100
2014-07-29,2014,7,301,788,115,1204,0.25,0.25
2014-07-30,2014,7,368,817,101,1286,0.28615863141524100,0.28615863141524100
2014-07-31,2014,7,297,754,117,1168,0.2542808219178080,0.2542808219178080
2014-08-01,2014,8,288,920,125,1333,0.21605401350337600,0.21605401350337600
2014-08-02,2014,8,218,684,112,1014,0.21499013806706100,0.21499013806706100
2014-08-03,2014,8,184,561,90,835,0.22035928143712600,0.22035928143712600
2014-08-04,2014,8,227,504,83,814,0.2788697788697790,0.2788697788697790
2014-08-05,2014,8,302,780,105,1187,0.2544229149115420,0.2544229149115420
2014-08-06,2014,8,344,876,112,1332,0.25825825825825800,0.25825825825825800
2014-08-07,2014,8,336,796,115,1247,0.2694466720128310,0.2694466720128310
2014-08-08,2014,8,272,861,124,1257,0.2163882259347650,0.2163882259347650
2014-08-09,2014,8,226,799,117,1142,0.1978984238178630,0.1978984238178630
2014-08-10,2014,8,184,653,80,917,0.20065430752453700,0.20065430752453700
2014-08-11,2014,8,229,544,67,840,0.2726190476190480,0.2726190476190480
2014-08-12,2014,8,334,804,79,1217,0.2744453574363190,0.2744453574363190
2014-08-13,2014,8,311,872,106,1289,0.24127230411171500,0.24127230411171500
2014-08-14,2014,8,313,863,120,1296,0.24151234567901200,0.24151234567901200
2014-08-15,2014,8,330,902,130,1362,0.2422907488986780,0.2422907488986780
2014-08-16,2014,8,262,749,90,1101,0.23796548592188900,0.23796548592188900
2014-08-17,2014,8,187,562,70,819,0.22832722832722800,0.22832722832722800
2014-08-18,2014,8,256,525,63,844,0.3033175355450240,0.3033175355450240
2014-08-19,2014,8,336,799,117,1252,0.268370607028754,0.268370607028754
2014-08-20,2014,8,406,895,105,1406,0.2887624466571840,0.2887624466571840
2014-08-21,2014,8,349,772,107,1228,0.28420195439739400,0.28420195439739400
2014-08-22,2014,8,251,744,70,1065,0.23568075117370900,0.23568075117370900
2014-08-23,2014,8,253,690,77,1020,0.24803921568627500,0.24803921568627500
2014-08-24,2014,8,195,604,61,860,0.22674418604651200,0.22674418604651200
2014-08-25,2014,8,224,513,58,795,0.28176100628930800,0.28176100628930800
2014-08-26,2014,8,285,728,75,1088,0.2619485294117650,0.2619485294117650
2014-08-27,2014,8,311,860,97,1268,0.24526813880126200,0.24526813880126200
2014-08-28,2014,8,316,782,98,1196,0.26421404682274200,0.26421404682274200
2014-08-29,2014,8,230,757,87,1074,0.21415270018622000,0.21415270018622000
2014-08-30,2014,8,212,651,83,946,0.22410147991543300,0.22410147991543300
2014-08-31,2014,8,148,447,51,646,0.22910216718266300,0.22910216718266300
2014-09-01,2014,9,145,436,37,618,0.23462783171521000,0.23462783171521000
2014-09-02,2014,9,246,736,63,1045,0.23540669856459300,0.23540669856459300
2014-09-03,2014,9,377,873,92,1342,0.2809239940387480,0.2809239940387480
2014-09-04,2014,9,304,822,150,1276,0.23824451410658300,0.23824451410658300
2014-09-05,2014,9,364,910,116,1390,0.26187050359712200,0.26187050359712200
2014-09-06,2014,9,277,759,78,1114,0.24865350089766600,0.24865350089766600
2014-09-07,2014,9,211,556,53,820,0.2573170731707320,0.2573170731707320
2014-09-08,2014,9,206,561,60,827,0.24909310761789600,0.24909310761789600
2014-09-09,2014,9,301,708,76,1085,0.27741935483871000,0.27741935483871000
2014-09-10,2014,9,386,857,117,1360,0.2838235294117650,0.2838235294117650
2014-09-11,2014,9,359,839,100,1298,0.2765793528505390,0.2765793528505390
2014-09-12,2014,9,279,865,101,1245,0.22409638554216900,0.22409638554216900
2014-09-13,2014,9,185,708,92,985,0.18781725888324900,0.18781725888324900
2014-09-14,2014,9,169,568,60,797,0.2120451693851950,0.2120451693851950
2014-09-15,2014,9,234,616,60,910,0.2571428571428570,0.2571428571428570
2014-09-16,2014,9,367,791,129,1287,0.2851592851592850,0.2851592851592850
2014-09-17,2014,9,345,886,85,1316,0.2621580547112460,0.2621580547112460
2014-09-18,2014,9,363,882,108,1353,0.2682926829268290,0.2682926829268290
2014-09-19,2014,9,282,901,109,1292,0.21826625386996900,0.21826625386996900
2014-09-20,2014,9,234,778,100,1112,0.210431654676259,0.210431654676259
2014-09-21,2014,9,166,518,57,741,0.22402159244264500,0.22402159244264500
2014-09-22,2014,9,176,525,154,855,0.20584795321637400,0.20584795321637400
2014-09-23,2014,9,278,692,85,1055,0.26350710900473900,0.26350710900473900
2014-09-24,2014,9,304,778,88,1170,0.25982905982906000,0.25982905982906000
2014-09-25,2014,9,201,579,62,842,0.23871733966745800,0.23871733966745800
2014-09-26,2014,9,230,695,68,993,0.23162134944612300,0.23162134944612300
2014-09-27,2014,9,198,627,84,909,0.21782178217821800,0.21782178217821800
2014-09-28,2014,9,145,535,61,741,0.19568151147098500,0.19568151147098500
2014-09-29,2014,9,177,539,47,763,0.23197903014416800,0.23197903014416800
2014-09-30,2014,9,256,677,79,1012,0.25296442687747000,0.25296442687747000
2014-10-01,2014,10,336,842,84,1262,0.2662440570522980,0.2662440570522980
2014-10-02,2014,10,331,921,100,1352,0.2448224852071010,0.2448224852071010
2014-10-03,2014,10,328,877,89,1294,0.2534775888717160,0.2534775888717160
2014-10-04,2014,10,218,727,81,1026,0.2124756335282650,0.2124756335282650
2014-10-05,2014,10,178,580,57,815,0.2184049079754600,0.2184049079754600
2014-10-06,2014,10,214,615,64,893,0.23964165733482600,0.23964165733482600
2014-10-07,2014,10,312,803,116,1231,0.25345247766043900,0.25345247766043900
2014-10-08,2014,10,371,930,105,1406,0.26386913229018500,0.26386913229018500
2014-10-09,2014,10,349,942,121,1412,0.2471671388101980,0.2471671388101980
2014-10-10,2014,10,295,811,114,1220,0.24180327868852500,0.24180327868852500
2014-10-11,2014,10,204,734,65,1003,0.2033898305084750,0.2033898305084750
2014-10-12,2014,10,185,595,52,832,0.22235576923076900,0.22235576923076900
2014-10-13,2014,10,191,565,64,820,0.2329268292682930,0.2329268292682930
2014-10-14,2014,10,400,896,83,1379,0.290065264684554,0.290065264684554
2014-10-15,2014,10,331,923,94,1348,0.24554896142433200,0.24554896142433200
2014-10-16,2014,10,370,800,80,1250,0.296,0.296
2014-10-17,2014,10,346,926,93,1365,0.25347985347985300,0.25347985347985300
2014-10-18,2014,10,295,885,82,1262,0.23375594294770200,0.23375594294770200
2014-10-19,2014,10,175,586,47,808,0.21658415841584200,0.21658415841584200
2014-10-20,2014,10,224,571,54,849,0.26383981154299200,0.26383981154299200
2014-10-21,2014,10,361,852,92,1305,0.27662835249042100,0.27662835249042100
2014-10-22,2014,10,309,744,81,1134,0.2724867724867730,0.2724867724867730
2014-10-23,2014,10,289,660,63,1012,0.2855731225296440,0.2855731225296440
2014-10-24,2014,10,327,835,78,1240,0.26370967741935500,0.26370967741935500
2014-10-25,2014,10,213,805,71,1089,0.19559228650137700,0.19559228650137700
2014-10-26,2014,10,162,549,67,778,0.20822622107969200,0.20822622107969200
2014-10-27,2014,10,221,500,58,779,0.28369704749679100,0.28369704749679100
2014-10-28,2014,10,319,791,81,1191,0.2678421494542400,0.2678421494542400
2014-10-29,2014,10,358,751,121,1230,0.2910569105691060,0.2910569105691060
2014-10-30,2014,10,335,741,112,1188,0.281986531986532,0.281986531986532
2014-10-31,2014,10,225,556,42,823,0.2733900364520050,0.2733900364520050
2014-11-01,2014,11,195,596,39,830,0.23493975903614500,0.23493975903614500
2014-11-02,2014,11,171,417,40,628,0.27229299363057300,0.27229299363057300
2014-11-03,2014,11,212,489,46,747,0.2838018741633200,0.2838018741633200
2014-11-04,2014,11,267,707,91,1065,0.2507042253521130,0.2507042253521130
2014-11-05,2014,11,390,864,97,1351,0.28867505551443400,0.28867505551443400
2014-11-06,2014,11,357,720,80,1157,0.30855661192739800,0.30855661192739800
2014-11-07,2014,11,358,804,88,1250,0.2864,0.2864
2014-11-08,2014,11,251,672,72,995,0.2522613065326630,0.2522613065326630
2014-11-09,2014,11,170,540,49,759,0.22397891963109400,0.22397891963109400
2014-11-10,2014,11,229,532,53,814,0.28132678132678100,0.28132678132678100
2014-11-11,2014,11,308,806,76,1190,0.25882352941176500,0.25882352941176500
2014-11-12,2014,11,384,844,102,1330,0.2887218045112780,0.2887218045112780
2014-11-13,2014,11,293,727,94,1114,0.263016157989228,0.263016157989228
2014-11-14,2014,11,300,791,84,1175,0.2553191489361700,0.2553191489361700
2014-11-15,2014,11,243,760,81,1084,0.22416974169741700,0.22416974169741700
2014-11-16,2014,11,176,525,40,741,0.23751686909581600,0.23751686909581600
2014-11-17,2014,11,195,463,51,709,0.2750352609308890,0.2750352609308890
2014-11-18,2014,11,304,668,66,1038,0.2928709055876690,0.2928709055876690
2014-11-19,2014,11,344,713,100,1157,0.29732065687121900,0.29732065687121900
2014-11-20,2014,11,398,800,93,1291,0.308288148721921,0.308288148721921
2014-11-21,2014,11,315,792,65,1172,0.2687713310580210,0.2687713310580210
2014-11-22,2014,11,212,820,86,1118,0.18962432915921300,0.18962432915921300
2014-11-23,2014,11,132,534,52,718,0.18384401114206100,0.18384401114206100
2014-11-24,2014,11,225,473,58,756,0.2976190476190480,0.2976190476190480
2014-11-25,2014,11,293,646,80,1019,0.2875368007850830,0.2875368007850830
2014-11-26,2014,11,193,427,44,664,0.29066265060241000,0.29066265060241000
2014-11-27,2014,11,65,181,24,270,0.24074074074074100,0.24074074074074100
2014-11-28,2014,11,193,623,57,873,0.22107674684994300,0.22107674684994300
2014-11-29,2014,11,191,658,58,907,0.2105843439911800,0.2105843439911800
2014-11-30,2014,11,139,456,39,634,0.2192429022082020,0.2192429022082020
2014-12-01,2014,12,186,454,45,685,0.27153284671532800,0.27153284671532800
2014-12-02,2014,12,317,694,76,1087,0.29162833486660500,0.29162833486660500
2014-12-03,2014,12,263,575,104,942,0.2791932059447980,0.2791932059447980
2014-12-04,2014,12,235,529,194,958,0.2453027139874740,0.2453027139874740
2014-12-05,2014,12,178,446,80,704,0.2528409090909090,0.2528409090909090
2014-12-06,2014,12,145,439,41,625,0.232,0.232
2014-12-07,2014,12,117,394,22,533,0.21951219512195100,0.21951219512195100
2014-12-08,2014,12,147,381,36,564,0.26063829787234000,0.26063829787234000
2014-12-09,2014,12,241,454,51,746,0.3230563002680970,0.3230563002680970
2014-12-10,2014,12,272,560,77,909,0.2992299229922990,0.2992299229922990
2014-12-11,2014,12,264,629,77,970,0.2721649484536080,0.2721649484536080
2014-12-12,2014,12,247,593,52,892,0.2769058295964130,0.2769058295964130
2014-12-13,2014,12,152,554,48,754,0.20159151193634000,0.20159151193634000
2014-12-14,2014,12,123,439,48,610,0.20163934426229500,0.20163934426229500
2014-12-15,2014,12,247,467,37,751,0.3288948069241010,0.3288948069241010
2014-12-16,2014,12,264,580,63,907,0.29106945975744200,0.29106945975744200
2014-12-17,2014,12,308,666,61,1035,0.2975845410628020,0.2975845410628020
2014-12-18,2014,12,272,561,53,886,0.30699774266365700,0.30699774266365700
2014-12-19,2014,12,215,599,31,845,0.25443786982248500,0.25443786982248500
2014-12-20,2014,12,135,443,37,615,0.21951219512195100,0.21951219512195100
2014-12-21,2014,12,103,194,2,299,0.34448160535117100,0.34448160535117100
2014-12-22,2014,12,112,205,6,323,0.34674922600619200,0.34674922600619200
2014-12-23,2014,12,127,206,3,336,0.37797619047619000,0.37797619047619000
2014-12-24,2014,12,73,147,3,223,0.3273542600896860,0.3273542600896860
2014-12-25,2014,12,55,79,2,136,0.40441176470588200,0.40441176470588200
2014-12-26,2014,12,104,179,4,287,0.3623693379790940,0.3623693379790940
2014-12-27,2014,12,75,159,2,236,0.3177966101694920,0.3177966101694920
2014-12-28,2014,12,79,174,3,256,0.30859375,0.30859375
2014-12-29,2014,12,102,213,1,316,0.3227848101265820,0.3227848101265820
2014-12-30,2014,12,127,248,2,377,0.33687002652519900,0.33687002652519900
2014-12-31,2014,12,76,128,1,205,0.37073170731707300,0.37073170731707300
2015-01-01,2015,1,158,247,5,410,0.3853658536585370,0.3853658536585370
2015-01-02,2015,1,196,263,8,467,0.4197002141327620,0.4197002141327620
2015-01-03,2015,1,140,220,2,362,0.3867403314917130,0.3867403314917130
2015-01-04,2015,1,87,148,0,235,0.3702127659574470,0.3702127659574470
2015-01-05,2015,1,155,249,4,408,0.3799019607843140,0.3799019607843140
2015-01-06,2015,1,235,323,7,565,0.415929203539823,0.415929203539823
2015-01-07,2015,1,303,372,12,687,0.4410480349344980,0.4410480349344980
2015-01-08,2015,1,269,453,30,752,0.35771276595744700,0.35771276595744700
2015-01-09,2015,1,238,547,61,846,0.28132387706855800,0.28132387706855800
2015-01-10,2015,1,215,551,71,837,0.25686977299880500,0.25686977299880500
2015-01-11,2015,1,129,378,25,532,0.2424812030075190,0.2424812030075190
2015-01-12,2015,1,200,413,36,649,0.3081664098613250,0.3081664098613250
2015-01-13,2015,1,378,707,69,1154,0.3275563258232240,0.3275563258232240
2015-01-14,2015,1,400,756,91,1247,0.32076984763432200,0.32076984763432200
2015-01-15,2015,1,357,740,80,1177,0.3033135089209860,0.3033135089209860
2015-01-16,2015,1,261,734,86,1081,0.2414431082331180,0.2414431082331180
2015-01-17,2015,1,221,654,60,935,0.23636363636363600,0.23636363636363600
2015-01-18,2015,1,116,452,42,610,0.1901639344262300,0.1901639344262300
2015-01-19,2015,1,144,507,53,704,0.20454545454545500,0.20454545454545500
2015-01-20,2015,1,325,785,69,1179,0.27565733672603900,0.27565733672603900
2015-01-21,2015,1,369,769,92,1230,0.3,0.3
2015-01-22,2015,1,396,799,95,1290,0.30697674418604700,0.30697674418604700
2015-01-23,2015,1,328,802,99,1229,0.26688364524003300,0.26688364524003300
2015-01-24,2015,1,197,554,62,813,0.24231242312423100,0.24231242312423100
2015-01-25,2015,1,134,470,32,636,0.21069182389937100,0.21069182389937100
2015-01-26,2015,1,117,242,12,371,0.31536388140161700,0.31536388140161700
2015-01-27,2015,1,122,345,17,484,0.25206611570247900,0.25206611570247900
2015-01-28,2015,1,328,692,72,1092,0.30036630036630000,0.30036630036630000
2015-01-29,2015,1,320,707,92,1119,0.28596961572832900,0.28596961572832900
2015-01-30,2015,1,286,729,76,1091,0.2621448212648950,0.2621448212648950
2015-01-31,2015,1,188,633,76,897,0.20958751393534000,0.20958751393534000
2015-02-01,2015,2,103,394,39,536,0.1921641791044780,0.1921641791044780
2015-02-02,2015,2,138,282,28,448,0.3080357142857140,0.3080357142857140
2015-02-03,2015,2,282,580,71,933,0.3022508038585210,0.3022508038585210
2015-02-04,2015,2,344,744,91,1179,0.2917726887192540,0.2917726887192540
2015-02-05,2015,2,381,734,83,1198,0.31803005008347200,0.31803005008347200
2015-02-06,2015,2,326,740,79,1145,0.2847161572052400,0.2847161572052400
2015-02-07,2015,2,224,691,90,1005,0.2228855721393040,0.2228855721393040
2015-02-08,2015,2,166,541,68,775,0.21419354838709700,0.21419354838709700
2015-02-09,2015,2,183,421,54,658,0.27811550151975700,0.27811550151975700
2015-02-10,2015,2,416,693,70,1179,0.35284139100933000,0.35284139100933000
2015-02-11,2015,2,369,859,89,1317,0.28018223234624100,0.28018223234624100
2015-02-12,2015,2,381,853,131,1365,0.27912087912087900,0.27912087912087900
2015-02-13,2015,2,243,683,91,1017,0.23893805309734500,0.23893805309734500
2015-02-14,2015,2,179,598,73,850,0.21058823529411800,0.21058823529411800
2015-02-15,2015,2,124,477,38,639,0.19405320813771500,0.19405320813771500
2015-02-16,2015,2,146,463,35,644,0.2267080745341620,0.2267080745341620
2015-02-17,2015,2,274,673,66,1013,0.2704837117472850,0.2704837117472850
2015-02-18,2015,2,324,786,84,1194,0.271356783919598,0.271356783919598
2015-02-19,2015,2,281,697,88,1066,0.26360225140712900,0.26360225140712900
2015-02-20,2015,2,241,684,55,980,0.24591836734693900,0.24591836734693900
2015-02-21,2015,2,192,583,62,837,0.22939068100358400,0.22939068100358400
2015-02-22,2015,2,138,449,51,638,0.21630094043887100,0.21630094043887100
2015-02-23,2015,2,218,452,42,712,0.3061797752808990,0.3061797752808990
2015-02-24,2015,2,261,676,72,1009,0.25867195242814700,0.25867195242814700
2015-02-25,2015,2,359,784,90,1233,0.2911597729115980,0.2911597729115980
2015-02-26,2015,2,334,739,108,1181,0.28281117696867100,0.28281117696867100
2015-02-27,2015,2,265,723,116,1104,0.24003623188405800,0.24003623188405800
2015-02-28,2015,2,212,664,57,933,0.22722400857449100,0.22722400857449100
2015-03-01,2015,3,131,420,46,597,0.21943048576214400,0.21943048576214400
2015-03-02,2015,3,196,491,30,717,0.2733612273361230,0.2733612273361230
2015-03-03,2015,3,255,616,55,926,0.275377969762419,0.275377969762419
2015-03-04,2015,3,368,771,83,1222,0.3011456628477910,0.3011456628477910
2015-03-05,2015,3,209,492,86,787,0.2655654383735710,0.2655654383735710
2015-03-06,2015,3,258,724,100,1082,0.23844731977818900,0.23844731977818900
2015-03-07,2015,3,264,746,83,1093,0.2415370539798720,0.2415370539798720
2015-03-08,2015,3,152,452,48,652,0.2331288343558280,0.2331288343558280
2015-03-09,2015,3,225,549,52,826,0.27239709443099300,0.27239709443099300
2015-03-10,2015,3,338,726,71,1135,0.29779735682819400,0.29779735682819400
2015-03-11,2015,3,378,813,119,1310,0.2885496183206110,0.2885496183206110
2015-03-12,2015,3,315,836,109,1260,0.25,0.25
2015-03-13,2015,3,251,784,116,1151,0.21807124239791500,0.21807124239791500
2015-03-14,2015,3,216,708,86,1010,0.21386138613861400,0.21386138613861400
2015-03-15,2015,3,139,550,42,731,0.19015047879617000,0.19015047879617000
2015-03-16,2015,3,242,514,68,824,0.2936893203883500,0.2936893203883500
2015-03-17,2015,3,222,637,72,931,0.23845327604726100,0.23845327604726100
2015-03-18,2015,3,338,770,89,1197,0.28237259816207200,0.28237259816207200
2015-03-19,2015,3,291,734,82,1107,0.26287262872628700,0.26287262872628700
2015-03-20,2015,3,259,646,78,983,0.2634791454730420,0.2634791454730420
2015-03-21,2015,3,194,710,79,983,0.19735503560529000,0.19735503560529000
2015-03-22,2015,3,172,560,62,794,0.21662468513853900,0.21662468513853900
2015-03-23,2015,3,222,555,47,824,0.26941747572815500,0.26941747572815500
2015-03-24,2015,3,259,674,62,995,0.26030150753768800,0.26030150753768800
2015-03-25,2015,3,335,744,68,1147,0.2920662598081950,0.2920662598081950
2015-03-26,2015,3,293,737,95,1125,0.2604444444444440,0.2604444444444440
2015-03-27,2015,3,247,729,134,1110,0.22252252252252300,0.22252252252252300
2015-03-28,2015,3,215,603,58,876,0.2454337899543380,0.2454337899543380
2015-03-29,2015,3,156,481,51,688,0.22674418604651200,0.22674418604651200
2015-03-30,2015,3,181,457,43,681,0.2657856093979440,0.2657856093979440
2015-03-31,2015,3,284,563,72,919,0.30903155603917300,0.30903155603917300
2015-04-01,2015,4,300,809,82,1191,0.2518891687657430,0.2518891687657430
2015-04-02,2015,4,313,839,80,1232,0.25405844155844200,0.25405844155844200
2015-04-03,2015,4,269,752,80,1101,0.24432334241598500,0.24432334241598500
2015-04-04,2015,4,182,623,80,885,0.20564971751412400,0.20564971751412400
2015-04-05,2015,4,101,322,40,463,0.21814254859611200,0.21814254859611200
2015-04-06,2015,4,189,503,43,735,0.2571428571428570,0.2571428571428570
2015-04-07,2015,4,258,683,69,1010,0.25544554455445500,0.25544554455445500
2015-04-08,2015,4,319,777,82,1178,0.2707979626485570,0.2707979626485570
2015-04-09,2015,4,272,739,78,1089,0.2497704315886130,0.2497704315886130
2015-04-10,2015,4,244,613,76,933,0.2615219721329050,0.2615219721329050
2015-04-11,2015,4,208,654,84,946,0.21987315010570800,0.21987315010570800
2015-04-12,2015,4,142,462,56,660,0.21515151515151500,0.21515151515151500
2015-04-13,2015,4,241,525,57,823,0.2928311057108140,0.2928311057108140
2015-04-14,2015,4,276,735,109,1120,0.24642857142857100,0.24642857142857100
2015-04-15,2015,4,349,732,115,1196,0.29180602006689000,0.29180602006689000
2015-04-16,2015,4,350,769,94,1213,0.2885408079142620,0.2885408079142620
2015-04-17,2015,4,327,733,143,1203,0.2718204488778060,0.2718204488778060
2015-04-18,2015,4,180,642,122,944,0.1906779661016950,0.1906779661016950
2015-04-19,2015,4,155,492,41,688,0.22529069767441900,0.22529069767441900
2015-04-20,2015,4,199,471,57,727,0.2737276478679510,0.2737276478679510
2015-04-21,2015,4,349,793,92,1234,0.28282009724473300,0.28282009724473300
2015-04-22,2015,4,284,771,91,1146,0.24781849912740000,0.24781849912740000
2015-04-23,2015,4,334,809,80,1223,0.27309893704006500,0.27309893704006500
2015-04-24,2015,4,269,681,82,1032,0.2606589147286820,0.2606589147286820
2015-04-25,2015,4,187,644,79,910,0.20549450549450500,0.20549450549450500
2015-04-26,2015,4,166,532,60,758,0.21899736147757300,0.21899736147757300
2015-04-27,2015,4,198,473,52,723,0.27385892116182600,0.27385892116182600
2015-04-28,2015,4,300,680,71,1051,0.285442435775452,0.285442435775452
2015-04-29,2015,4,312,668,187,1167,0.26735218508997400,0.26735218508997400
2015-04-30,2015,4,322,701,68,1091,0.29514207149404200,0.29514207149404200
2015-05-01,2015,5,281,629,69,979,0.2870275791624110,0.2870275791624110
2015-05-02,2015,5,165,477,52,694,0.2377521613832850,0.2377521613832850
2015-05-03,2015,5,136,424,54,614,0.22149837133550500,0.22149837133550500
2015-05-04,2015,5,163,399,35,597,0.2730318257956450,0.2730318257956450
2015-05-05,2015,5,302,675,82,1059,0.28517469310670400,0.28517469310670400
2015-05-06,2015,5,302,695,93,1090,0.27706422018348600,0.27706422018348600
2015-05-07,2015,5,296,700,94,1090,0.27155963302752300,0.27155963302752300
2015-05-08,2015,5,128,453,63,644,0.19875776397515500,0.19875776397515500
2015-05-09,2015,5,209,594,91,894,0.23378076062639800,0.23378076062639800
2015-05-10,2015,5,156,391,59,606,0.25742574257425700,0.25742574257425700
2015-05-11,2015,5,211,505,40,756,0.2791005291005290,0.2791005291005290
2015-05-12,2015,5,311,685,79,1075,0.28930232558139500,0.28930232558139500
2015-05-13,2015,5,373,799,101,1273,0.29300864100549900,0.29300864100549900
2015-05-14,2015,5,302,796,77,1175,0.2570212765957450,0.2570212765957450
2015-05-15,2015,5,250,718,118,1086,0.2302025782688770,0.2302025782688770
2015-05-16,2015,5,176,685,76,937,0.18783351120597700,0.18783351120597700
2015-05-17,2015,5,180,503,57,740,0.24324324324324300,0.24324324324324300
2015-05-18,2015,5,256,511,47,814,0.3144963144963150,0.3144963144963150
2015-05-19,2015,5,282,655,64,1001,0.2817182817182820,0.2817182817182820
2015-05-20,2015,5,341,757,59,1157,0.29472774416594600,0.29472774416594600
2015-05-21,2015,5,319,744,67,1130,0.28230088495575200,0.28230088495575200
2015-05-22,2015,5,262,694,80,1036,0.2528957528957530,0.2528957528957530
2015-05-23,2015,5,192,604,81,877,0.21892816419612300,0.21892816419612300
2015-05-24,2015,5,129,485,63,677,0.19054652880354500,0.19054652880354500
2015-05-25,2015,5,127,437,58,622,0.20418006430868200,0.20418006430868200
2015-05-26,2015,5,297,636,70,1003,0.29611166500498500,0.29611166500498500
2015-05-27,2015,5,341,701,84,1126,0.302841918294849,0.302841918294849
2015-05-28,2015,5,302,692,63,1057,0.2857142857142860,0.2857142857142860
2015-05-29,2015,5,279,627,85,991,0.2815338042381430,0.2815338042381430
2015-05-30,2015,5,229,673,80,982,0.23319755600814700,0.23319755600814700
2015-05-31,2015,5,134,452,44,630,0.2126984126984130,0.2126984126984130
2015-06-01,2015,6,163,421,45,629,0.2591414944356120,0.2591414944356120
2015-06-02,2015,6,281,613,54,948,0.29641350210970500,0.29641350210970500
2015-06-03,2015,6,278,733,60,1071,0.25957049486461300,0.25957049486461300
2015-06-04,2015,6,339,823,107,1269,0.26713947990543700,0.26713947990543700
2015-06-05,2015,6,282,776,107,1165,0.24206008583691000,0.24206008583691000
2015-06-06,2015,6,244,719,76,1039,0.23484119345524500,0.23484119345524500
2015-06-07,2015,6,157,570,69,796,0.1972361809045230,0.1972361809045230
2015-06-08,2015,6,216,531,59,806,0.2679900744416870,0.2679900744416870
2015-06-09,2015,6,309,682,66,1057,0.2923368022705770,0.2923368022705770
2015-06-10,2015,6,317,761,112,1190,0.26638655462184900,0.26638655462184900
2015-06-11,2015,6,321,706,89,1116,0.28763440860215100,0.28763440860215100
2015-06-12,2015,6,235,747,76,1058,0.222117202268431,0.222117202268431
2015-06-13,2015,6,176,587,75,838,0.2100238663484490,0.2100238663484490
2015-06-14,2015,6,172,572,54,798,0.21553884711779400,0.21553884711779400
2015-06-15,2015,6,223,485,49,757,0.29458388375165100,0.29458388375165100
2015-06-16,2015,6,308,713,80,1101,0.27974568574023600,0.27974568574023600
2015-06-17,2015,6,302,720,86,1108,0.27256317689530700,0.27256317689530700
2015-06-18,2015,6,316,704,101,1121,0.2818911685994650,0.2818911685994650
2015-06-19,2015,6,266,745,79,1090,0.24403669724770600,0.24403669724770600
2015-06-20,2015,6,238,643,70,951,0.2502628811777080,0.2502628811777080
2015-06-21,2015,6,155,404,55,614,0.252442996742671,0.252442996742671
2015-06-22,2015,6,197,490,60,747,0.2637215528781790,0.2637215528781790
2015-06-23,2015,6,310,639,65,1014,0.3057199211045370,0.3057199211045370
2015-06-24,2015,6,325,682,71,1078,0.3014842300556590,0.3014842300556590
2015-06-25,2015,6,317,775,73,1165,0.2721030042918460,0.2721030042918460
2015-06-26,2015,6,251,647,66,964,0.2603734439834030,0.2603734439834030
2015-06-27,2015,6,199,537,52,788,0.25253807106599000,0.25253807106599000
2015-06-28,2015,6,133,398,41,572,0.23251748251748300,0.23251748251748300
2015-06-29,2015,6,189,462,37,688,0.2747093023255810,0.2747093023255810
2015-06-30,2015,6,266,587,64,917,0.2900763358778630,0.2900763358778630
2015-07-01,2015,7,350,758,78,1186,0.2951096121416530,0.2951096121416530
2015-07-02,2015,7,289,684,102,1075,0.2688372093023260,0.2688372093023260
2015-07-03,2015,7,274,741,85,1100,0.24909090909090900,0.24909090909090900
2015-07-04,2015,7,177,482,58,717,0.24686192468619200,0.24686192468619200
2015-07-05,2015,7,173,530,55,758,0.22823218997361500,0.22823218997361500
2015-07-06,2015,7,193,465,48,706,0.273371104815864,0.273371104815864
2015-07-07,2015,7,322,739,73,1134,0.2839506172839510,0.2839506172839510
2015-07-08,2015,7,377,714,91,1182,0.3189509306260580,0.3189509306260580
2015-07-09,2015,7,317,655,89,1061,0.2987747408105560,0.2987747408105560
2015-07-10,2015,7,200,579,71,850,0.23529411764705900,0.23529411764705900
2015-07-11,2015,7,219,610,61,890,0.24606741573033700,0.24606741573033700
2015-07-12,2015,7,188,466,52,706,0.26628895184136000,0.26628895184136000
2015-07-13,2015,7,262,518,49,829,0.316043425814234,0.316043425814234
2015-07-14,2015,7,265,704,84,1053,0.251661918328585,0.251661918328585
2015-07-15,2015,7,319,772,112,1203,0.2651704073150460,0.2651704073150460
2015-07-16,2015,7,335,713,89,1137,0.29463500439753700,0.29463500439753700
2015-07-17,2015,7,233,614,106,953,0.24449108079748200,0.24449108079748200
2015-07-18,2015,7,229,607,61,897,0.2552954292084730,0.2552954292084730
2015-07-19,2015,7,173,450,58,681,0.2540381791483110,0.2540381791483110
2015-07-20,2015,7,222,471,57,750,0.296,0.296
2015-07-21,2015,7,267,696,81,1044,0.2557471264367820,0.2557471264367820
2015-07-22,2015,7,347,772,88,1207,0.2874896437448220,0.2874896437448220
2015-07-23,2015,7,367,785,82,1234,0.29740680713128000,0.29740680713128000
2015-07-24,2015,7,257,728,93,1078,0.23840445269016700,0.23840445269016700
2015-07-25,2015,7,232,670,70,972,0.23868312757201600,0.23868312757201600
2015-07-26,2015,7,206,505,72,783,0.26309067688378000,0.26309067688378000
2015-07-27,2015,7,177,472,39,688,0.25726744186046500,0.25726744186046500
2015-07-28,2015,7,267,592,75,934,0.28586723768736600,0.28586723768736600
2015-07-29,2015,7,382,655,77,1114,0.34290843806104100,0.34290843806104100
2015-07-30,2015,7,277,666,87,1030,0.2689320388349520,0.2689320388349520
2015-07-31,2015,7,249,610,95,954,0.2610062893081760,0.2610062893081760
2015-08-01,2015,8,271,625,67,963,0.2814122533748700,0.2814122533748700
2015-08-02,2015,8,195,470,62,727,0.26822558459422300,0.26822558459422300
2015-08-03,2015,8,254,483,55,792,0.3207070707070710,0.3207070707070710
2015-08-04,2015,8,346,681,85,1112,0.31115107913669100,0.31115107913669100
2015-08-05,2015,8,377,823,112,1312,0.28734756097561000,0.28734756097561000
2015-08-06,2015,8,346,795,114,1255,0.2756972111553790,0.2756972111553790
2015-08-07,2015,8,307,783,130,1220,0.25163934426229500,0.25163934426229500
2015-08-08,2015,8,214,717,93,1024,0.208984375,0.208984375
2015-08-09,2015,8,166,519,71,756,0.21957671957672000,0.21957671957672000
2015-08-10,2015,8,264,500,42,806,0.32754342431761800,0.32754342431761800
2015-08-11,2015,8,290,668,74,1032,0.2810077519379850,0.2810077519379850
2015-08-12,2015,8,390,843,95,1328,0.2936746987951810,0.2936746987951810
2015-08-13,2015,8,352,737,114,1203,0.29260182876143000,0.29260182876143000
2015-08-14,2015,8,305,745,115,1165,0.26180257510729600,0.26180257510729600
2015-08-15,2015,8,224,660,77,961,0.23309053069719000,0.23309053069719000
2015-08-16,2015,8,198,510,68,776,0.2551546391752580,0.2551546391752580
2015-08-17,2015,8,216,470,47,733,0.2946793997271490,0.2946793997271490
2015-08-18,2015,8,337,784,87,1208,0.27897350993377500,0.27897350993377500
2015-08-19,2015,8,377,748,82,1207,0.3123446561723280,0.3123446561723280
2015-08-20,2015,8,336,738,89,1163,0.2889079965606190,0.2889079965606190
2015-08-21,2015,8,259,702,132,1093,0.23696248856358600,0.23696248856358600
2015-08-22,2015,8,265,674,76,1015,0.26108374384236500,0.26108374384236500
2015-08-23,2015,8,161,488,54,703,0.22901849217638700,0.22901849217638700
2015-08-24,2015,8,237,505,49,791,0.2996207332490520,0.2996207332490520
2015-08-25,2015,8,279,651,100,1030,0.270873786407767,0.270873786407767
2015-08-26,2015,8,371,776,80,1227,0.3023634881825590,0.3023634881825590
2015-08-27,2015,8,303,752,72,1127,0.2688553682342500,0.2688553682342500
2015-08-28,2015,8,266,715,84,1065,0.24976525821596200,0.24976525821596200
2015-08-29,2015,8,201,664,69,934,0.215203426124197,0.215203426124197
2015-08-30,2015,8,202,464,65,731,0.2763337893296850,0.2763337893296850
2015-08-31,2015,8,165,435,44,644,0.2562111801242240,0.2562111801242240
2015-09-01,2015,9,320,644,89,1053,0.30389363722697100,0.30389363722697100
2015-09-02,2015,9,298,779,80,1157,0.2575626620570440,0.2575626620570440
2015-09-03,2015,9,332,752,90,1174,0.282793867120954,0.282793867120954
2015-09-04,2015,9,294,717,81,1092,0.2692307692307690,0.2692307692307690
2015-09-05,2015,9,265,725,78,1068,0.24812734082397000,0.24812734082397000
2015-09-06,2015,9,172,494,52,718,0.2395543175487470,0.2395543175487470
2015-09-07,2015,9,154,395,38,587,0.262350936967632,0.262350936967632
2015-09-08,2015,9,305,640,63,1008,0.30257936507936500,0.30257936507936500
2015-09-09,2015,9,301,753,73,1127,0.2670807453416150,0.2670807453416150
2015-09-10,2015,9,315,641,70,1026,0.30701754385964900,0.30701754385964900
2015-09-11,2015,9,305,641,66,1012,0.30138339920948600,0.30138339920948600
2015-09-12,2015,9,210,640,65,915,0.22950819672131100,0.22950819672131100
2015-09-13,2015,9,173,438,50,661,0.2617246596066570,0.2617246596066570
2015-09-14,2015,9,195,517,51,763,0.25557011795543900,0.25557011795543900
2015-09-15,2015,9,320,726,91,1137,0.28144239226033400,0.28144239226033400
2015-09-16,2015,9,357,700,100,1157,0.30855661192739800,0.30855661192739800
2015-09-17,2015,9,308,720,84,1112,0.27697841726618700,0.27697841726618700
2015-09-18,2015,9,295,817,99,1211,0.24360033030553300,0.24360033030553300
2015-09-19,2015,9,216,713,69,998,0.21643286573146300,0.21643286573146300
2015-09-20,2015,9,212,476,53,741,0.28609986504723300,0.28609986504723300
2015-09-21,2015,9,241,504,50,795,0.3031446540880500,0.3031446540880500
2015-09-22,2015,9,313,755,83,1151,0.2719374456993920,0.2719374456993920
2015-09-23,2015,9,358,795,97,1250,0.2864,0.2864
2015-09-24,2015,9,270,582,59,911,0.29637760702524700,0.29637760702524700
2015-09-25,2015,9,195,460,39,694,0.28097982708933700,0.28097982708933700
2015-09-26,2015,9,176,544,63,783,0.2247765006385700,0.2247765006385700
2015-09-27,2015,9,121,427,51,599,0.2020033388981640,0.2020033388981640
2015-09-28,2015,9,183,437,40,660,0.2772727272727270,0.2772727272727270
2015-09-29,2015,9,262,630,72,964,0.2717842323651450,0.2717842323651450
2015-09-30,2015,9,294,620,61,975,0.30153846153846200,0.30153846153846200
2015-10-01,2015,10,372,680,72,1124,0.3309608540925270,0.3309608540925270
2015-10-02,2015,10,189,528,76,793,0.23833543505674700,0.23833543505674700
2015-10-03,2015,10,200,547,62,809,0.24721878862793600,0.24721878862793600
2015-10-04,2015,10,172,503,54,729,0.23593964334705100,0.23593964334705100
2015-10-05,2015,10,248,533,37,818,0.30317848410757900,0.30317848410757900
2015-10-06,2015,10,345,698,84,1127,0.30612244897959200,0.30612244897959200
2015-10-07,2015,10,371,749,88,1208,0.30711920529801300,0.30711920529801300
2015-10-08,2015,10,350,785,107,1242,0.28180354267310800,0.28180354267310800
2015-10-09,2015,10,310,709,71,1090,0.28440366972477100,0.28440366972477100
2015-10-10,2015,10,234,586,69,889,0.26321709786276700,0.26321709786276700
2015-10-11,2015,10,171,491,47,709,0.24118476727785600,0.24118476727785600
2015-10-12,2015,10,179,501,60,740,0.2418918918918920,0.2418918918918920
2015-10-13,2015,10,320,720,82,1122,0.28520499108734400,0.28520499108734400
2015-10-14,2015,10,352,771,88,1211,0.2906688687035510,0.2906688687035510
2015-10-15,2015,10,382,756,77,1215,0.31440329218107000,0.31440329218107000
2015-10-16,2015,10,313,753,79,1145,0.27336244541484700,0.27336244541484700
2015-10-17,2015,10,221,583,65,869,0.25431530494821600,0.25431530494821600
2015-10-18,2015,10,149,456,29,634,0.23501577287066200,0.23501577287066200
2015-10-19,2015,10,218,513,40,771,0.2827496757457850,0.2827496757457850
2015-10-20,2015,10,260,721,69,1050,0.24761904761904800,0.24761904761904800
2015-10-21,2015,10,355,683,70,1108,0.3203971119133570,0.3203971119133570
2015-10-22,2015,10,363,707,93,1163,0.31212381771281200,0.31212381771281200
2015-10-23,2015,10,318,712,83,1113,0.2857142857142860,0.2857142857142860
2015-10-24,2015,10,208,545,62,815,0.2552147239263800,0.2552147239263800
2015-10-25,2015,10,148,412,37,597,0.24790619765494100,0.24790619765494100
2015-10-26,2015,10,199,432,43,674,0.2952522255192880,0.2952522255192880
2015-10-27,2015,10,306,530,57,893,0.3426651735722280,0.3426651735722280
2015-10-28,2015,10,140,323,27,490,0.2857142857142860,0.2857142857142860
2015-10-29,2015,10,273,609,58,940,0.2904255319148940,0.2904255319148940
2015-10-30,2015,10,265,597,67,929,0.2852529601722280,0.2852529601722280
2015-10-31,2015,10,245,460,39,744,0.3293010752688170,0.3293010752688170
2015-11-01,2015,11,152,417,23,592,0.25675675675675700,0.25675675675675700
2015-11-02,2015,11,219,426,41,686,0.31924198250728900,0.31924198250728900
2015-11-03,2015,11,319,570,65,954,0.33438155136268300,0.33438155136268300
2015-11-04,2015,11,370,714,139,1223,0.30253475061324600,0.30253475061324600
2015-11-05,2015,11,341,618,77,1036,0.32915057915057900,0.32915057915057900
2015-11-06,2015,11,323,632,95,1050,0.3076190476190480,0.3076190476190480
2015-11-07,2015,11,229,606,70,905,0.25303867403314900,0.25303867403314900
2015-11-08,2015,11,138,424,40,602,0.2292358803986710,0.2292358803986710
2015-11-09,2015,11,257,466,47,770,0.33376623376623400,0.33376623376623400
2015-11-10,2015,11,310,536,50,896,0.34598214285714300,0.34598214285714300
2015-11-11,2015,11,315,745,74,1134,0.2777777777777780,0.2777777777777780
2015-11-12,2015,11,313,641,65,1019,0.3071638861629050,0.3071638861629050
2015-11-13,2015,11,317,680,65,1062,0.2984934086629000,0.2984934086629000
2015-11-14,2015,11,210,516,58,784,0.26785714285714300,0.26785714285714300
2015-11-15,2015,11,165,445,31,641,0.2574102964118570,0.2574102964118570
2015-11-16,2015,11,260,489,33,782,0.33248081841432200,0.33248081841432200
2015-11-17,2015,11,331,692,66,1089,0.3039485766758490,0.3039485766758490
2015-11-18,2015,11,335,726,96,1157,0.2895419187554020,0.2895419187554020
2015-11-19,2015,11,290,601,82,973,0.29804727646454300,0.29804727646454300
2015-11-20,2015,11,302,721,85,1108,0.27256317689530700,0.27256317689530700
2015-11-21,2015,11,222,678,71,971,0.2286302780638520,0.2286302780638520
2015-11-22,2015,11,165,438,36,639,0.25821596244131500,0.25821596244131500
2015-11-23,2015,11,208,412,37,657,0.3165905631659060,0.3165905631659060
2015-11-24,2015,11,297,669,64,1030,0.2883495145631070,0.2883495145631070
2015-11-25,2015,11,234,523,62,819,0.2857142857142860,0.2857142857142860
2015-11-26,2015,11,77,213,6,296,0.26013513513513500,0.26013513513513500
2015-11-27,2015,11,207,602,41,850,0.24352941176470600,0.24352941176470600
2015-11-28,2015,11,220,567,54,841,0.2615933412604040,0.2615933412604040
2015-11-29,2015,11,145,404,34,583,0.24871355060034300,0.24871355060034300
2015-11-30,2015,11,223,434,36,693,0.3217893217893220,0.3217893217893220
2015-12-01,2015,12,308,572,51,931,0.3308270676691730,0.3308270676691730
2015-12-02,2015,12,330,625,92,1047,0.3151862464183380,0.3151862464183380
2015-12-03,2015,12,349,681,79,1109,0.3146979260595130,0.3146979260595130
2015-12-04,2015,12,291,656,91,1038,0.28034682080924900,0.28034682080924900
2015-12-05,2015,12,228,652,48,928,0.24568965517241400,0.24568965517241400
2015-12-06,2015,12,140,441,42,623,0.2247191011235960,0.2247191011235960
2015-12-07,2015,12,193,481,41,715,0.2699300699300700,0.2699300699300700
2015-12-08,2015,12,313,672,70,1055,0.2966824644549760,0.2966824644549760
2015-12-09,2015,12,307,614,74,995,0.3085427135678390,0.3085427135678390
2015-12-10,2015,12,284,602,67,953,0.29800629590766000,0.29800629590766000
2015-12-11,2015,12,290,682,68,1040,0.27884615384615400,0.27884615384615400
2015-12-12,2015,12,241,627,73,941,0.2561105207226360,0.2561105207226360
2015-12-13,2015,12,168,452,45,665,0.25263157894736800,0.25263157894736800
2015-12-14,2015,12,238,451,46,735,0.3238095238095240,0.3238095238095240
2015-12-15,2015,12,369,616,57,1042,0.354126679462572,0.354126679462572
2015-12-16,2015,12,289,644,71,1004,0.28784860557768900,0.28784860557768900
2015-12-17,2015,12,232,519,56,807,0.2874845105328380,0.2874845105328380
2015-12-18,2015,12,288,547,43,878,0.32801822323462400,0.32801822323462400
2015-12-19,2015,12,241,529,45,815,0.29570552147239300,0.29570552147239300
2015-12-20,2015,12,114,420,36,570,0.2,0.2
2015-12-21,2015,12,182,442,36,660,0.27575757575757600,0.27575757575757600
2015-12-22,2015,12,239,630,52,921,0.25950054288816500,0.25950054288816500
2015-12-23,2015,12,166,417,41,624,0.266025641025641,0.266025641025641
2015-12-24,2015,12,83,217,7,307,0.2703583061889250,0.2703583061889250
2015-12-25,2015,12,68,111,4,183,0.37158469945355200,0.37158469945355200
2015-12-26,2015,12,153,398,25,576,0.265625,0.265625
2015-12-27,2015,12,140,367,32,539,0.2597402597402600,0.2597402597402600
2015-12-28,2015,12,187,434,31,652,0.28680981595092000,0.28680981595092000
2015-12-29,2015,12,226,538,43,807,0.28004956629491900,0.28004956629491900
2015-12-30,2015,12,193,410,39,642,0.30062305295950200,0.30062305295950200
2015-12-31,2015,12,104,303,27,434,0.23963133640553000,0.23963133640553000
2016-01-01,2016,1,218,497,25,740,0.2945945945945950,0.2945945945945950
2016-01-02,2016,1,215,512,35,762,0.2821522309711290,0.2821522309711290
2016-01-03,2016,1,161,367,26,554,0.29061371841155200,0.29061371841155200
2016-01-04,2016,1,203,405,33,641,0.3166926677067080,0.3166926677067080
2016-01-05,2016,1,275,604,44,923,0.2979414951245940,0.2979414951245940
2016-01-06,2016,1,335,744,100,1179,0.28413910093299400,0.28413910093299400
2016-01-07,2016,1,387,719,94,1200,0.3225,0.3225
2016-01-08,2016,1,303,679,64,1046,0.28967495219885300,0.28967495219885300
2016-01-09,2016,1,247,619,46,912,0.2708333333333330,0.2708333333333330
2016-01-10,2016,1,140,431,31,602,0.23255813953488400,0.23255813953488400
2016-01-11,2016,1,211,529,41,781,0.2701664532650450,0.2701664532650450
2016-01-12,2016,1,304,687,72,1063,0.28598306679209800,0.28598306679209800
2016-01-13,2016,1,349,699,53,1101,0.3169845594913720,0.3169845594913720
2016-01-14,2016,1,315,676,56,1047,0.3008595988538680,0.3008595988538680
2016-01-15,2016,1,314,751,90,1155,0.27186147186147200,0.27186147186147200
2016-01-16,2016,1,246,618,67,931,0.26423200859291100,0.26423200859291100
2016-01-17,2016,1,149,462,30,641,0.23244929797191900,0.23244929797191900
2016-01-18,2016,1,172,505,39,716,0.24022346368715100,0.24022346368715100
2016-01-19,2016,1,253,611,66,930,0.27204301075268800,0.27204301075268800
2016-01-20,2016,1,351,725,57,1133,0.30979699911738700,0.30979699911738700
2016-01-21,2016,1,321,786,99,1206,0.26616915422885600,0.26616915422885600
2016-01-22,2016,1,269,654,62,985,0.2730964467005080,0.2730964467005080
2016-01-23,2016,1,77,161,8,246,0.3130081300813010,0.3130081300813010
2016-01-24,2016,1,59,163,8,230,0.2565217391304350,0.2565217391304350
2016-01-25,2016,1,199,373,19,591,0.33671742808798600,0.33671742808798600
2016-01-26,2016,1,271,575,56,902,0.3004434589800440,0.3004434589800440
2016-01-27,2016,1,335,748,95,1178,0.2843803056027170,0.2843803056027170
2016-01-28,2016,1,332,675,94,1101,0.30154405086285200,0.30154405086285200
2016-01-29,2016,1,313,638,70,1021,0.30656219392752200,0.30656219392752200
2016-01-30,2016,1,240,594,62,896,0.26785714285714300,0.26785714285714300
2016-01-31,2016,1,207,448,50,705,0.2936170212765960,0.2936170212765960
2016-02-01,2016,2,241,511,40,792,0.3042929292929290,0.3042929292929290
2016-02-02,2016,2,310,734,64,1108,0.27978339350180500,0.27978339350180500
2016-02-03,2016,2,348,706,79,1133,0.30714916151809400,0.30714916151809400
2016-02-04,2016,2,392,781,97,1270,0.30866141732283500,0.30866141732283500
2016-02-05,2016,2,297,637,101,1035,0.28695652173913000,0.28695652173913000
2016-02-06,2016,2,228,677,79,984,0.23170731707317100,0.23170731707317100
2016-02-07,2016,2,111,401,39,551,0.2014519056261340,0.2014519056261340
2016-02-08,2016,2,174,454,48,676,0.257396449704142,0.257396449704142
2016-02-09,2016,2,312,673,59,1044,0.2988505747126440,0.2988505747126440
2016-02-10,2016,2,399,718,60,1177,0.3389974511469840,0.3389974511469840
2016-02-11,2016,2,332,709,131,1172,0.2832764505119450,0.2832764505119450
2016-02-12,2016,2,302,626,82,1010,0.299009900990099,0.299009900990099
2016-02-13,2016,2,165,523,50,738,0.22357723577235800,0.22357723577235800
2016-02-14,2016,2,99,292,31,422,0.23459715639810400,0.23459715639810400
2016-02-15,2016,2,169,437,24,630,0.26825396825396800,0.26825396825396800
2016-02-16,2016,2,269,479,68,816,0.32965686274509800,0.32965686274509800
2016-02-17,2016,2,425,762,77,1264,0.3362341772151900,0.3362341772151900
2016-02-18,2016,2,354,730,65,1149,0.30809399477806800,0.30809399477806800
2016-02-19,2016,2,318,687,63,1068,0.29775280898876400,0.29775280898876400
2016-02-20,2016,2,218,659,59,936,0.2329059829059830,0.2329059829059830
2016-02-21,2016,2,183,437,41,661,0.27685325264750400,0.27685325264750400
2016-02-22,2016,2,232,563,51,846,0.27423167848699800,0.27423167848699800
2016-02-23,2016,2,281,630,54,965,0.2911917098445600,0.2911917098445600
2016-02-24,2016,2,305,626,100,1031,0.29582929194956400,0.29582929194956400
2016-02-25,2016,2,334,644,86,1064,0.31390977443609000,0.31390977443609000
2016-02-26,2016,2,291,647,69,1007,0.28897715988083400,0.28897715988083400
2016-02-27,2016,2,232,587,44,863,0.2688296639629200,0.2688296639629200
2016-02-28,2016,2,153,436,38,627,0.24401913875598100,0.24401913875598100
2016-02-29,2016,2,211,463,37,711,0.2967651195499300,0.2967651195499300
2016-03-01,2016,3,328,715,65,1108,0.296028880866426,0.296028880866426
2016-03-02,2016,3,379,650,36,1065,0.355868544600939,0.355868544600939
2016-03-03,2016,3,326,730,21,1077,0.30269266480965600,0.30269266480965600
2016-03-04,2016,3,264,674,25,963,0.27414330218068500,0.27414330218068500
2016-03-05,2016,3,212,663,28,903,0.23477297895902500,0.23477297895902500
2016-03-06,2016,3,199,498,24,721,0.27600554785020800,0.27600554785020800
2016-03-07,2016,3,239,488,18,745,0.3208053691275170,0.3208053691275170
2016-03-08,2016,3,345,747,25,1117,0.3088630259623990,0.3088630259623990
2016-03-09,2016,3,421,783,33,1237,0.3403395311236860,0.3403395311236860
2016-03-10,2016,3,358,795,36,1189,0.3010933557611440,0.3010933557611440
2016-03-11,2016,3,329,765,28,1122,0.29322638146167600,0.29322638146167600
2016-03-12,2016,3,205,656,30,891,0.23007856341189700,0.23007856341189700
2016-03-13,2016,3,175,472,21,668,0.2619760479041920,0.2619760479041920
2016-03-14,2016,3,244,366,12,622,0.39228295819935700,0.39228295819935700
2016-03-15,2016,3,408,672,25,1105,0.36923076923076900,0.36923076923076900
2016-03-16,2016,3,321,742,25,1088,0.29503676470588200,0.29503676470588200
2016-03-17,2016,3,269,619,24,912,0.2949561403508770,0.2949561403508770
2016-03-18,2016,3,333,677,27,1037,0.32111861137897800,0.32111861137897800
2016-03-19,2016,3,231,605,23,859,0.2689173457508730,0.2689173457508730
2016-03-20,2016,3,141,414,15,570,0.24736842105263200,0.24736842105263200
2016-03-21,2016,3,188,481,13,682,0.2756598240469210,0.2756598240469210
2016-03-22,2016,3,327,576,15,918,0.3562091503267970,0.3562091503267970
2016-03-23,2016,3,339,685,25,1049,0.323164918970448,0.323164918970448
2016-03-24,2016,3,294,614,59,967,0.30403309203722900,0.30403309203722900
2016-03-25,2016,3,269,593,14,876,0.3070776255707760,0.3070776255707760
2016-03-26,2016,3,225,567,16,808,0.2784653465346540,0.2784653465346540
2016-03-27,2016,3,115,335,11,461,0.24945770065075900,0.24945770065075900
2016-03-28,2016,3,190,435,14,639,0.297339593114241,0.297339593114241
2016-03-29,2016,3,296,569,11,876,0.3378995433789950,0.3378995433789950
2016-03-30,2016,3,275,704,24,1003,0.2741774675972080,0.2741774675972080
2016-03-31,2016,3,326,661,21,1008,0.32341269841269800,0.32341269841269800
2016-04-01,2016,4,300,683,19,1002,0.2994011976047900,0.2994011976047900
2016-04-02,2016,4,208,573,14,795,0.26163522012578600,0.26163522012578600
2016-04-03,2016,4,131,401,17,549,0.23861566484517300,0.23861566484517300
2016-04-04,2016,4,252,404,6,662,0.3806646525679760,0.3806646525679760
2016-04-05,2016,4,274,578,11,863,0.3174971031286210,0.3174971031286210
2016-04-06,2016,4,379,760,14,1153,0.32870771899392900,0.32870771899392900
2016-04-07,2016,4,342,687,25,1054,0.32447817836812100,0.32447817836812100
2016-04-08,2016,4,280,679,28,987,0.28368794326241100,0.28368794326241100
2016-04-09,2016,4,193,628,20,841,0.2294887039239000,0.2294887039239000
2016-04-10,2016,4,161,452,22,635,0.25354330708661400,0.25354330708661400
2016-04-11,2016,4,256,483,14,753,0.3399734395750330,0.3399734395750330
2016-04-12,2016,4,296,562,13,871,0.33983926521240000,0.33983926521240000
2016-04-13,2016,4,407,754,22,1183,0.3440405748098060,0.3440405748098060
2016-04-14,2016,4,380,711,45,1136,0.3345070422535210,0.3345070422535210
2016-04-15,2016,4,343,718,32,1093,0.3138151875571820,0.3138151875571820
2016-04-16,2016,4,241,638,32,911,0.2645444566410540,0.2645444566410540
2016-04-17,2016,4,141,502,21,664,0.21234939759036100,0.21234939759036100
2016-04-18,2016,4,230,511,24,765,0.3006535947712420,0.3006535947712420
2016-04-19,2016,4,252,579,19,850,0.2964705882352940,0.2964705882352940
2016-04-20,2016,4,363,752,22,1137,0.31926121372031700,0.31926121372031700
2016-04-21,2016,4,301,646,24,971,0.309989701338826,0.309989701338826
2016-04-22,2016,4,279,650,18,947,0.2946145723336850,0.2946145723336850
2016-04-23,2016,4,203,563,25,791,0.25663716814159300,0.25663716814159300
2016-04-24,2016,4,129,448,21,598,0.2157190635451510,0.2157190635451510
2016-04-25,2016,4,208,442,21,671,0.30998509687034300,0.30998509687034300
2016-04-26,2016,4,280,574,11,865,0.3236994219653180,0.3236994219653180
2016-04-27,2016,4,403,650,14,1067,0.3776944704779760,0.3776944704779760
2016-04-28,2016,4,326,688,22,1036,0.31467181467181500,0.31467181467181500
2016-04-29,2016,4,285,648,19,952,0.29936974789916000,0.29936974789916000
2016-04-30,2016,4,232,531,25,788,0.29441624365482200,0.29441624365482200
2016-05-01,2016,5,130,370,26,526,0.24714828897338400,0.24714828897338400
2016-05-02,2016,5,223,482,16,721,0.3092926490984740,0.3092926490984740
2016-05-03,2016,5,338,616,16,970,0.34845360824742300,0.34845360824742300
2016-05-04,2016,5,347,713,15,1075,0.3227906976744190,0.3227906976744190
2016-05-05,2016,5,314,745,13,1072,0.292910447761194,0.292910447761194
2016-05-06,2016,5,308,678,29,1015,0.30344827586206900,0.30344827586206900
2016-05-07,2016,5,189,567,28,784,0.24107142857142900,0.24107142857142900
2016-05-08,2016,5,143,430,21,594,0.24074074074074100,0.24074074074074100
2016-05-09,2016,5,250,500,21,771,0.324254215304799,0.324254215304799
2016-05-10,2016,5,359,738,22,1119,0.32082216264521900,0.32082216264521900
2016-05-11,2016,5,417,779,34,1230,0.33902439024390200,0.33902439024390200
2016-05-12,2016,5,410,737,32,1179,0.3477523324851570,0.3477523324851570
2016-05-13,2016,5,305,691,30,1026,0.297270955165692,0.297270955165692
2016-05-14,2016,5,209,709,25,943,0.22163308589607600,0.22163308589607600
2016-05-15,2016,5,178,498,33,709,0.25105782792665700,0.25105782792665700
2016-05-16,2016,5,231,502,28,761,0.3035479632063080,0.3035479632063080
2016-05-17,2016,5,343,706,23,1072,0.3199626865671640,0.3199626865671640
2016-05-18,2016,5,375,776,17,1168,0.3210616438356160,0.3210616438356160
2016-05-19,2016,5,362,717,23,1102,0.32849364791288600,0.32849364791288600
2016-05-20,2016,5,305,660,33,998,0.30561122244489000,0.30561122244489000
2016-05-21,2016,5,206,571,40,817,0.2521419828641370,0.2521419828641370
2016-05-22,2016,5,166,464,25,655,0.2534351145038170,0.2534351145038170
2016-05-23,2016,5,240,484,16,740,0.32432432432432400,0.32432432432432400
2016-05-24,2016,5,322,636,23,981,0.32823649337410800,0.32823649337410800
2016-05-25,2016,5,325,694,43,1062,0.3060263653483990,0.3060263653483990
2016-05-26,2016,5,336,715,34,1085,0.3096774193548390,0.3096774193548390
2016-05-27,2016,5,258,606,29,893,0.2889137737961930,0.2889137737961930
2016-05-28,2016,5,172,616,40,828,0.20772946859903400,0.20772946859903400
2016-05-29,2016,5,151,387,32,570,0.2649122807017540,0.2649122807017540
2016-05-30,2016,5,145,336,22,503,0.2882703777335980,0.2882703777335980
2016-05-31,2016,5,312,578,26,916,0.3406113537117900,0.3406113537117900
2016-06-01,2016,6,387,747,33,1167,0.33161953727506400,0.33161953727506400
2016-06-02,2016,6,398,739,30,1167,0.34104541559554400,0.34104541559554400
2016-06-03,2016,6,308,597,34,939,0.32800851970181000,0.32800851970181000
2016-06-04,2016,6,187,612,41,840,0.2226190476190480,0.2226190476190480
2016-06-05,2016,6,160,417,25,602,0.26578073089701,0.26578073089701
2016-06-06,2016,6,258,553,20,831,0.3104693140794220,0.3104693140794220
2016-06-07,2016,6,258,589,16,863,0.2989571263035920,0.2989571263035920
2016-06-08,2016,6,339,627,16,982,0.34521384928716900,0.34521384928716900
2016-06-09,2016,6,276,673,22,971,0.2842430484037080,0.2842430484037080
2016-06-10,2016,6,302,639,43,984,0.30691056910569100,0.30691056910569100
2016-06-11,2016,6,221,587,42,850,0.26,0.26
2016-06-12,2016,6,141,487,28,656,0.2149390243902440,0.2149390243902440
2016-06-13,2016,6,228,442,21,691,0.3299565846599130,0.3299565846599130
2016-06-14,2016,6,292,643,24,959,0.3044838373305530,0.3044838373305530
2016-06-15,2016,6,356,708,20,1084,0.3284132841328410,0.3284132841328410
2016-06-16,2016,6,277,694,36,1007,0.27507447864945400,0.27507447864945400
2016-06-17,2016,6,296,624,33,953,0.310598111227702,0.310598111227702
2016-06-18,2016,6,170,529,28,727,0.23383768913342500,0.23383768913342500
2016-06-19,2016,6,140,374,37,551,0.2540834845735030,0.2540834845735030
2016-06-20,2016,6,218,479,17,714,0.30532212885154100,0.30532212885154100
2016-06-21,2016,6,296,675,20,991,0.29868819374369300,0.29868819374369300
2016-06-22,2016,6,303,663,36,1002,0.3023952095808380,0.3023952095808380
2016-06-23,2016,6,289,671,35,995,0.2904522613065330,0.2904522613065330
2016-06-24,2016,6,260,564,27,851,0.30552291421856600,0.30552291421856600
2016-06-25,2016,6,195,533,30,758,0.25725593667546200,0.25725593667546200
2016-06-26,2016,6,166,415,17,598,0.27759197324414700,0.27759197324414700
2016-06-27,2016,6,194,445,16,655,0.2961832061068700,0.2961832061068700
2016-06-28,2016,6,258,560,12,830,0.3108433734939760,0.3108433734939760
2016-06-29,2016,6,370,633,26,1029,0.3595724003887270,0.3595724003887270
2016-06-30,2016,6,346,613,16,975,0.3548717948717950,0.3548717948717950
2016-07-01,2016,7,284,601,26,911,0.31174533479692600,0.31174533479692600
2016-07-02,2016,7,234,585,39,858,0.2727272727272730,0.2727272727272730
2016-07-03,2016,7,168,479,30,677,0.2481536189069420,0.2481536189069420
2016-07-04,2016,7,160,374,24,558,0.2867383512544800,0.2867383512544800
2016-07-05,2016,7,284,573,17,874,0.32494279176201400,0.32494279176201400
2016-07-06,2016,7,365,661,25,1051,0.3472882968601330,0.3472882968601330
2016-07-07,2016,7,326,727,32,1085,0.30046082949308800,0.30046082949308800
2016-07-08,2016,7,236,426,19,681,0.3465491923641700,0.3465491923641700
2016-07-09,2016,7,172,445,22,639,0.26917057902973400,0.26917057902973400
2016-07-10,2016,7,166,378,25,569,0.29173989455184500,0.29173989455184500
2016-07-11,2016,7,224,397,9,630,0.35555555555555600,0.35555555555555600
2016-07-12,2016,7,318,498,19,835,0.38083832335329300,0.38083832335329300
2016-07-13,2016,7,284,637,16,937,0.3030949839914620,0.3030949839914620
2016-07-14,2016,7,306,563,24,893,0.3426651735722280,0.3426651735722280
2016-07-15,2016,7,292,554,21,867,0.33679354094579000,0.33679354094579000
2016-07-16,2016,7,162,527,30,719,0.22531293463143300,0.22531293463143300
2016-07-17,2016,7,146,356,28,530,0.27547169811320800,0.27547169811320800
2016-07-18,2016,7,253,360,10,623,0.406099518459069,0.406099518459069
2016-07-19,2016,7,317,582,14,913,0.34720700985761200,0.34720700985761200
2016-07-20,2016,7,329,601,18,948,0.3470464135021100,0.3470464135021100
2016-07-21,2016,7,313,588,36,937,0.33404482390608300,0.33404482390608300
2016-07-22,2016,7,257,507,31,795,0.3232704402515720,0.3232704402515720
2016-07-23,2016,7,190,478,35,703,0.2702702702702700,0.2702702702702700
2016-07-24,2016,7,189,434,24,647,0.2921174652241110,0.2921174652241110
2016-07-25,2016,7,220,371,19,610,0.36065573770491800,0.36065573770491800
2016-07-26,2016,7,285,567,16,868,0.3283410138248850,0.3283410138248850
2016-07-27,2016,7,359,631,21,1011,0.35509396636993100,0.35509396636993100
2016-07-28,2016,7,311,591,29,931,0.33404940923737900,0.33404940923737900
2016-07-29,2016,7,242,518,21,781,0.30985915492957700,0.30985915492957700
2016-07-30,2016,7,208,464,21,693,0.30014430014430000,0.30014430014430000
2016-07-31,2016,7,132,380,18,530,0.2490566037735850,0.2490566037735850
2016-08-01,2016,8,221,400,19,640,0.3453125,0.3453125
2016-08-02,2016,8,328,551,28,907,0.36163175303197400,0.36163175303197400
2016-08-03,2016,8,386,690,29,1105,0.34932126696832600,0.34932126696832600
2016-08-04,2016,8,319,649,24,992,0.3215725806451610,0.3215725806451610
2016-08-05,2016,8,292,636,36,964,0.3029045643153530,0.3029045643153530
2016-08-06,2016,8,192,513,27,732,0.26229508196721300,0.26229508196721300
2016-08-07,2016,8,149,449,24,622,0.2395498392282960,0.2395498392282960
2016-08-08,2016,8,251,491,20,762,0.3293963254593180,0.3293963254593180
2016-08-09,2016,8,265,573,37,875,0.3028571428571430,0.3028571428571430
2016-08-10,2016,8,356,634,22,1012,0.35177865612648200,0.35177865612648200
2016-08-11,2016,8,314,635,26,975,0.32205128205128200,0.32205128205128200
2016-08-12,2016,8,265,600,24,889,0.2980877390326210,0.2980877390326210
2016-08-13,2016,8,213,516,32,761,0.27989487516425800,0.27989487516425800
2016-08-14,2016,8,151,439,34,624,0.2419871794871800,0.2419871794871800
2016-08-15,2016,8,196,439,15,650,0.30153846153846200,0.30153846153846200
2016-08-16,2016,8,319,594,22,935,0.3411764705882350,0.3411764705882350
2016-08-17,2016,8,367,692,21,1080,0.3398148148148150,0.3398148148148150
2016-08-18,2016,8,310,671,16,997,0.31093279839518600,0.31093279839518600
2016-08-19,2016,8,250,603,29,882,0.2834467120181410,0.2834467120181410
2016-08-20,2016,8,230,548,28,806,0.2853598014888340,0.2853598014888340
2016-08-21,2016,8,181,401,28,610,0.2967213114754100,0.2967213114754100
2016-08-22,2016,8,237,461,20,718,0.33008356545961000,0.33008356545961000
2016-08-23,2016,8,321,612,21,954,0.33647798742138400,0.33647798742138400
2016-08-24,2016,8,417,656,23,1096,0.38047445255474500,0.38047445255474500
2016-08-25,2016,8,336,724,29,1089,0.3085399449035810,0.3085399449035810
2016-08-26,2016,8,262,700,29,991,0.26437941473259300,0.26437941473259300
2016-08-27,2016,8,208,592,32,832,0.25,0.25
2016-08-28,2016,8,183,466,31,680,0.2691176470588240,0.2691176470588240
2016-08-29,2016,8,187,412,12,611,0.3060556464811780,0.3060556464811780
2016-08-30,2016,8,315,560,17,892,0.3531390134529150,0.3531390134529150
2016-08-31,2016,8,336,651,30,1017,0.3303834808259590,0.3303834808259590
2016-09-01,2016,9,261,610,25,896,0.29129464285714300,0.29129464285714300
2016-09-02,2016,9,345,622,31,998,0.3456913827655310,0.3456913827655310
2016-09-03,2016,9,268,522,39,829,0.3232810615199040,0.3232810615199040
2016-09-04,2016,9,192,453,29,674,0.28486646884273,0.28486646884273
2016-09-05,2016,9,162,396,18,576,0.28125,0.28125
2016-09-06,2016,9,259,614,16,889,0.29133858267716500,0.29133858267716500
2016-09-07,2016,9,364,597,17,978,0.3721881390593050,0.3721881390593050
2016-09-08,2016,9,342,645,25,1012,0.33794466403162100,0.33794466403162100
2016-09-09,2016,9,266,552,23,841,0.3162901307966710,0.3162901307966710
2016-09-10,2016,9,206,508,37,751,0.27430093209054600,0.27430093209054600
2016-09-11,2016,9,128,426,23,577,0.2218370883882150,0.2218370883882150
2016-09-12,2016,9,209,494,11,714,0.2927170868347340,0.2927170868347340
2016-09-13,2016,9,262,569,16,847,0.30932703659976400,0.30932703659976400
2016-09-14,2016,9,342,697,35,1074,0.31843575418994400,0.31843575418994400
2016-09-15,2016,9,362,750,21,1133,0.3195057369814650,0.3195057369814650
2016-09-16,2016,9,266,628,30,924,0.2878787878787880,0.2878787878787880
2016-09-17,2016,9,178,553,15,746,0.2386058981233240,0.2386058981233240
2016-09-18,2016,9,139,401,20,560,0.24821428571428600,0.24821428571428600
2016-09-19,2016,9,183,333,11,527,0.34724857685009500,0.34724857685009500
2016-09-20,2016,9,248,580,19,847,0.29279811097992900,0.29279811097992900
2016-09-21,2016,9,344,637,27,1008,0.3412698412698410,0.3412698412698410
2016-09-22,2016,9,332,630,30,992,0.3346774193548390,0.3346774193548390
2016-09-23,2016,9,301,549,32,882,0.3412698412698410,0.3412698412698410
2016-09-24,2016,9,198,488,25,711,0.27848101265822800,0.27848101265822800
2016-09-25,2016,9,128,447,19,594,0.21548821548821500,0.21548821548821500
2016-09-26,2016,9,199,439,19,657,0.3028919330289190,0.3028919330289190
2016-09-27,2016,9,285,584,24,893,0.3191489361702130,0.3191489361702130
2016-09-28,2016,9,341,625,17,983,0.34689725330620500,0.34689725330620500
2016-09-29,2016,9,312,668,15,995,0.3135678391959800,0.3135678391959800
2016-09-30,2016,9,200,455,12,667,0.29985007496251900,0.29985007496251900
2016-10-01,2016,10,204,505,30,739,0.27604871447902600,0.27604871447902600
2016-10-02,2016,10,184,409,25,618,0.2977346278317150,0.2977346278317150
2016-10-03,2016,10,215,465,12,692,0.3106936416184970,0.3106936416184970
2016-10-04,2016,10,344,676,19,1039,0.3310875842155920,0.3310875842155920
2016-10-05,2016,10,347,716,27,1090,0.318348623853211,0.318348623853211
2016-10-06,2016,10,347,684,24,1055,0.3289099526066350,0.3289099526066350
2016-10-07,2016,10,305,646,30,981,0.3109072375127420,0.3109072375127420
2016-10-08,2016,10,201,608,29,838,0.2398568019093080,0.2398568019093080
2016-10-09,2016,10,139,378,19,536,0.2593283582089550,0.2593283582089550
2016-10-10,2016,10,177,421,10,608,0.2911184210526320,0.2911184210526320
2016-10-11,2016,10,290,655,28,973,0.29804727646454300,0.29804727646454300
2016-10-12,2016,10,394,736,21,1151,0.3423110338835800,0.3423110338835800
2016-10-13,2016,10,330,733,26,1089,0.30303030303030300,0.30303030303030300
2016-10-14,2016,10,313,641,33,987,0.3171225937183380,0.3171225937183380
2016-10-15,2016,10,215,575,42,832,0.25841346153846200,0.25841346153846200
2016-10-16,2016,10,210,454,34,698,0.3008595988538680,0.3008595988538680
2016-10-17,2016,10,207,552,28,787,0.2630241423125790,0.2630241423125790
2016-10-18,2016,10,303,701,19,1023,0.2961876832844580,0.2961876832844580
2016-10-19,2016,10,346,789,36,1171,0.2954739538855680,0.2954739538855680
2016-10-20,2016,10,354,630,24,1008,0.35119047619047600,0.35119047619047600
2016-10-21,2016,10,290,610,31,931,0.31149301825993600,0.31149301825993600
2016-10-22,2016,10,207,574,26,807,0.25650557620817800,0.25650557620817800
2016-10-23,2016,10,141,428,18,587,0.2402044293015330,0.2402044293015330
2016-10-24,2016,10,227,488,15,730,0.31095890410958900,0.31095890410958900
2016-10-25,2016,10,328,588,19,935,0.3508021390374330,0.3508021390374330
2016-10-26,2016,10,335,680,9,1024,0.3271484375,0.3271484375
2016-10-27,2016,10,285,584,14,883,0.32276330690826700,0.32276330690826700
2016-10-28,2016,10,271,603,22,896,0.30245535714285700,0.30245535714285700
2016-10-29,2016,10,217,585,24,826,0.2627118644067800,0.2627118644067800
2016-10-30,2016,10,153,423,27,603,0.2537313432835820,0.2537313432835820
2016-10-31,2016,10,156,358,21,535,0.29158878504672900,0.29158878504672900
2016-11-01,2016,11,303,595,15,913,0.33187294633077800,0.33187294633077800
2016-11-02,2016,11,378,724,25,1127,0.33540372670807500,0.33540372670807500
2016-11-03,2016,11,344,691,21,1056,0.32575757575757600,0.32575757575757600
2016-11-04,2016,11,296,665,17,978,0.30265848670756600,0.30265848670756600
2016-11-05,2016,11,240,523,30,793,0.3026481715006310,0.3026481715006310
2016-11-06,2016,11,154,373,24,551,0.279491833030853,0.279491833030853
2016-11-07,2016,11,180,433,15,628,0.28662420382165600,0.28662420382165600
2016-11-08,2016,11,232,479,7,718,0.3231197771587740,0.3231197771587740
2016-11-09,2016,11,298,488,70,856,0.34813084112149500,0.34813084112149500
2016-11-10,2016,11,171,368,10,549,0.3114754098360660,0.3114754098360660
2016-11-11,2016,11,244,558,43,845,0.28875739644970400,0.28875739644970400
2016-11-12,2016,11,188,550,20,758,0.24802110817942000,0.24802110817942000
2016-11-13,2016,11,149,386,18,553,0.2694394213381560,0.2694394213381560
2016-11-14,2016,11,209,414,19,642,0.32554517133956400,0.32554517133956400
2016-11-15,2016,11,240,487,50,777,0.3088803088803090,0.3088803088803090
2016-11-16,2016,11,327,671,16,1014,0.3224852071005920,0.3224852071005920
2016-11-17,2016,11,309,702,27,1038,0.2976878612716760,0.2976878612716760
2016-11-18,2016,11,285,691,27,1003,0.28414755732801600,0.28414755732801600
2016-11-19,2016,11,203,659,21,883,0.22989807474518700,0.22989807474518700
2016-11-20,2016,11,118,377,19,514,0.22957198443579800,0.22957198443579800
2016-11-21,2016,11,196,433,12,641,0.30577223088923600,0.30577223088923600
2016-11-22,2016,11,300,552,7,859,0.3492433061699650,0.3492433061699650
2016-11-23,2016,11,229,544,9,782,0.2928388746803070,0.2928388746803070
2016-11-24,2016,11,66,219,4,289,0.22837370242214500,0.22837370242214500
2016-11-25,2016,11,201,533,23,757,0.2655217965653900,0.2655217965653900
2016-11-26,2016,11,214,591,21,826,0.25907990314770000,0.25907990314770000
2016-11-27,2016,11,159,447,27,633,0.25118483412322300,0.25118483412322300
2016-11-28,2016,11,249,415,23,687,0.3624454148471620,0.3624454148471620
2016-11-29,2016,11,237,467,38,742,0.3194070080862530,0.3194070080862530
2016-11-30,2016,11,278,500,18,796,0.3492462311557790,0.3492462311557790
2016-12-01,2016,12,333,643,19,995,0.33467336683417100,0.33467336683417100
2016-12-02,2016,12,284,615,32,931,0.3050483351235230,0.3050483351235230
2016-12-03,2016,12,208,595,33,836,0.24880382775119600,0.24880382775119600
2016-12-04,2016,12,147,411,23,581,0.25301204819277100,0.25301204819277100
2016-12-05,2016,12,239,411,8,658,0.36322188449848000,0.36322188449848000
2016-12-06,2016,12,266,600,15,881,0.30192962542565300,0.30192962542565300
2016-12-07,2016,12,358,682,15,1055,0.33933649289099500,0.33933649289099500
2016-12-08,2016,12,332,649,21,1002,0.3313373253493010,0.3313373253493010
2016-12-09,2016,12,277,627,21,925,0.29945945945945900,0.29945945945945900
2016-12-10,2016,12,209,575,26,810,0.2580246913580250,0.2580246913580250
2016-12-11,2016,12,157,455,14,626,0.2507987220447280,0.2507987220447280
2016-12-12,2016,12,185,407,6,598,0.3093645484949830,0.3093645484949830
2016-12-13,2016,12,336,572,5,913,0.36801752464403100,0.36801752464403100
2016-12-14,2016,12,422,632,29,1083,0.3896583564173590,0.3896583564173590
2016-12-15,2016,12,268,502,13,783,0.34227330779054900,0.34227330779054900
2016-12-16,2016,12,215,474,10,699,0.30758226037196000,0.30758226037196000
2016-12-17,2016,12,152,463,15,630,0.24126984126984100,0.24126984126984100
2016-12-18,2016,12,134,424,15,573,0.2338568935427570,0.2338568935427570
2016-12-19,2016,12,196,405,9,610,0.32131147540983600,0.32131147540983600
2016-12-20,2016,12,324,547,8,879,0.36860068259385700,0.36860068259385700
2016-12-21,2016,12,442,575,17,1034,0.4274661508704060,0.4274661508704060
2016-12-22,2016,12,268,529,22,819,0.32722832722832700,0.32722832722832700
2016-12-23,2016,12,188,458,23,669,0.28101644245142000,0.28101644245142000
2016-12-24,2016,12,126,233,14,373,0.3378016085790890,0.3378016085790890
2016-12-25,2016,12,65,142,3,210,0.30952380952381000,0.30952380952381000
2016-12-26,2016,12,124,352,12,488,0.2540983606557380,0.2540983606557380
2016-12-27,2016,12,257,527,19,803,0.32004981320049800,0.32004981320049800
2016-12-28,2016,12,230,591,19,840,0.27380952380952400,0.27380952380952400
2016-12-29,2016,12,213,492,16,721,0.29542302357836300,0.29542302357836300
2016-12-30,2016,12,219,485,19,723,0.3029045643153530,0.3029045643153530
2016-12-31,2016,12,145,314,14,473,0.30655391120507400,0.30655391120507400
2017-01-01,2017,1,138,364,19,521,0.2648752399232250,0.2648752399232250
2017-01-02,2017,1,153,360,10,523,0.2925430210325050,0.2925430210325050
2017-01-03,2017,1,308,518,12,838,0.36754176610978500,0.36754176610978500
2017-01-04,2017,1,323,682,19,1024,0.3154296875,0.3154296875
2017-01-05,2017,1,378,693,18,1089,0.34710743801652900,0.34710743801652900
2017-01-06,2017,1,269,622,18,909,0.29592959295929600,0.29592959295929600
2017-01-07,2017,1,177,326,15,518,0.3416988416988420,0.3416988416988420
2017-01-08,2017,1,81,327,8,416,0.19471153846153800,0.19471153846153800
2017-01-09,2017,1,203,394,8,605,0.33553719008264500,0.33553719008264500
2017-01-10,2017,1,278,600,15,893,0.3113101903695410,0.3113101903695410
2017-01-11,2017,1,362,766,21,1149,0.31505657093124500,0.31505657093124500
2017-01-12,2017,1,411,728,26,1165,0.35278969957081500,0.35278969957081500
2017-01-13,2017,1,209,517,9,735,0.28435374149659900,0.28435374149659900
2017-01-14,2017,1,233,615,16,864,0.26967592592592600,0.26967592592592600
2017-01-15,2017,1,122,405,18,545,0.22385321100917400,0.22385321100917400
2017-01-16,2017,1,179,466,9,654,0.27370030581039800,0.27370030581039800
2017-01-17,2017,1,291,579,16,886,0.32844243792325100,0.32844243792325100
2017-01-18,2017,1,386,713,44,1143,0.33770778652668400,0.33770778652668400
2017-01-19,2017,1,343,685,19,1047,0.32760267430754500,0.32760267430754500
2017-01-20,2017,1,282,643,36,961,0.2934443288241420,0.2934443288241420
2017-01-21,2017,1,204,641,40,885,0.2305084745762710,0.2305084745762710
2017-01-22,2017,1,163,518,27,708,0.23022598870056500,0.23022598870056500
2017-01-23,2017,1,208,460,7,675,0.30814814814814800,0.30814814814814800
2017-01-24,2017,1,245,496,17,758,0.3232189973614780,0.3232189973614780
2017-01-25,2017,1,360,782,31,1173,0.3069053708439900,0.3069053708439900
2017-01-26,2017,1,336,715,23,1074,0.3128491620111730,0.3128491620111730
2017-01-27,2017,1,269,622,25,916,0.29366812227074200,0.29366812227074200
2017-01-28,2017,1,210,550,18,778,0.2699228791773780,0.2699228791773780
2017-01-29,2017,1,179,469,12,660,0.27121212121212100,0.27121212121212100
2017-01-30,2017,1,213,428,12,653,0.32618683001531400,0.32618683001531400
2017-01-31,2017,1,272,477,23,772,0.35233160621761700,0.35233160621761700
2017-02-01,2017,2,380,638,20,1038,0.36608863198458600,0.36608863198458600
2017-02-02,2017,2,336,702,31,1069,0.31431244153414400,0.31431244153414400
2017-02-03,2017,2,257,631,14,902,0.28492239467849200,0.28492239467849200
2017-02-04,2017,2,243,546,26,815,0.298159509202454,0.298159509202454
2017-02-05,2017,2,123,439,14,576,0.21354166666666700,0.21354166666666700
2017-02-06,2017,2,220,446,26,692,0.3179190751445090,0.3179190751445090
2017-02-07,2017,2,330,570,23,923,0.35752979414951200,0.35752979414951200
2017-02-08,2017,2,392,812,32,1236,0.31715210355987100,0.31715210355987100
2017-02-09,2017,2,163,295,15,473,0.34460887949260000,0.34460887949260000
2017-02-10,2017,2,269,581,15,865,0.3109826589595380,0.3109826589595380
2017-02-11,2017,2,223,611,32,866,0.2575057736720550,0.2575057736720550
2017-02-12,2017,2,174,434,15,623,0.27929373996789700,0.27929373996789700
2017-02-13,2017,2,204,439,15,658,0.3100303951367780,0.3100303951367780
2017-02-14,2017,2,292,550,14,856,0.3411214953271030,0.3411214953271030
2017-02-15,2017,2,375,701,20,1096,0.34215328467153300,0.34215328467153300
2017-02-16,2017,2,301,639,9,949,0.3171759747102210,0.3171759747102210
2017-02-17,2017,2,241,605,13,859,0.28055878928987200,0.28055878928987200
2017-02-18,2017,2,228,625,24,877,0.25997719498289600,0.25997719498289600
2017-02-19,2017,2,153,431,28,612,0.25,0.25
2017-02-20,2017,2,227,399,20,646,0.35139318885448900,0.35139318885448900
2017-02-21,2017,2,243,444,12,699,0.34763948497854100,0.34763948497854100
2017-02-22,2017,2,226,444,16,686,0.3294460641399420,0.3294460641399420
2017-02-23,2017,2,303,664,28,995,0.30452261306532700,0.30452261306532700
2017-02-24,2017,2,252,692,26,970,0.2597938144329900,0.2597938144329900
2017-02-25,2017,2,172,601,25,798,0.21553884711779400,0.21553884711779400
2017-02-26,2017,2,135,395,19,549,0.2459016393442620,0.2459016393442620
2017-02-27,2017,2,221,471,4,696,0.3175287356321840,0.3175287356321840
2017-02-28,2017,2,280,605,24,909,0.30803080308030800,0.30803080308030800
2017-03-01,2017,3,324,743,31,1098,0.29508196721311500,0.29508196721311500
2017-03-02,2017,3,282,607,19,908,0.31057268722467000,0.31057268722467000
2017-03-03,2017,3,264,621,31,916,0.28820960698690000,0.28820960698690000
2017-03-04,2017,3,195,603,12,810,0.24074074074074100,0.24074074074074100
2017-03-05,2017,3,148,462,13,623,0.2375601926163720,0.2375601926163720
2017-03-06,2017,3,255,503,14,772,0.33031088082901600,0.33031088082901600
2017-03-07,2017,3,369,696,16,1081,0.34135060129509700,0.34135060129509700
2017-03-08,2017,3,366,754,35,1155,0.3168831168831170,0.3168831168831170
2017-03-09,2017,3,378,700,27,1105,0.3420814479638010,0.3420814479638010
2017-03-10,2017,3,240,697,26,963,0.24922118380062300,0.24922118380062300
2017-03-11,2017,3,227,586,19,832,0.27283653846153800,0.27283653846153800
2017-03-12,2017,3,133,441,12,586,0.22696245733788400,0.22696245733788400
2017-03-13,2017,3,194,475,21,690,0.2811594202898550,0.2811594202898550
2017-03-14,2017,3,63,144,2,209,0.3014354066985650,0.3014354066985650
2017-03-15,2017,3,241,439,11,691,0.34876989869754000,0.34876989869754000
2017-03-16,2017,3,288,584,33,905,0.318232044198895,0.318232044198895
2017-03-17,2017,3,236,547,12,795,0.2968553459119500,0.2968553459119500
2017-03-18,2017,3,188,524,24,736,0.2554347826086960,0.2554347826086960
2017-03-19,2017,3,130,381,20,531,0.2448210922787190,0.2448210922787190
2017-03-20,2017,3,223,526,8,757,0.29458388375165100,0.29458388375165100
2017-03-21,2017,3,291,618,29,938,0.31023454157782500,0.31023454157782500
2017-03-22,2017,3,377,608,19,1004,0.3754980079681280,0.3754980079681280
2017-03-23,2017,3,323,635,27,985,0.32791878172588800,0.32791878172588800
2017-03-24,2017,3,265,546,19,830,0.3192771084337350,0.3192771084337350
2017-03-25,2017,3,216,569,21,806,0.2679900744416870,0.2679900744416870
2017-03-26,2017,3,149,405,15,569,0.2618629173989460,0.2618629173989460
2017-03-27,2017,3,204,483,19,706,0.28895184135977300,0.28895184135977300
2017-03-28,2017,3,238,520,15,773,0.3078913324708930,0.3078913324708930
2017-03-29,2017,3,300,618,27,945,0.31746031746031700,0.31746031746031700
2017-03-30,2017,3,293,605,32,930,0.3150537634408600,0.3150537634408600
2017-03-31,2017,3,217,439,15,671,0.323397913561848,0.323397913561848
2017-04-01,2017,4,206,579,25,810,0.254320987654321,0.254320987654321
2017-04-02,2017,4,140,445,24,609,0.22988505747126400,0.22988505747126400
2017-04-03,2017,4,243,480,28,751,0.3235685752330230,0.3235685752330230
2017-04-04,2017,4,314,620,24,958,0.3277661795407100,0.3277661795407100
2017-04-05,2017,4,355,727,28,1110,0.31981981981982000,0.31981981981982000
2017-04-06,2017,4,292,604,19,915,0.3191256830601090,0.3191256830601090
2017-04-07,2017,4,313,610,26,949,0.32982086406743900,0.32982086406743900
2017-04-08,2017,4,201,569,25,795,0.2528301886792450,0.2528301886792450
2017-04-09,2017,4,178,414,32,624,0.28525641025641000,0.28525641025641000
2017-04-10,2017,4,233,497,17,747,0.3119143239625170,0.3119143239625170
2017-04-11,2017,4,285,668,29,982,0.29022403258655800,0.29022403258655800
2017-04-12,2017,4,350,674,27,1051,0.3330161750713610,0.3330161750713610
2017-04-13,2017,4,278,673,40,991,0.2805247225025230,0.2805247225025230
2017-04-14,2017,4,239,592,25,856,0.27920560747663600,0.27920560747663600
2017-04-15,2017,4,191,488,21,700,0.27285714285714300,0.27285714285714300
2017-04-16,2017,4,131,317,20,468,0.2799145299145300,0.2799145299145300
2017-04-17,2017,4,224,528,26,778,0.2879177377892030,0.2879177377892030
2017-04-18,2017,4,285,581,15,881,0.32349602724177100,0.32349602724177100
2017-04-19,2017,4,357,671,19,1047,0.34097421203438400,0.34097421203438400
2017-04-20,2017,4,319,675,34,1028,0.3103112840466930,0.3103112840466930
2017-04-21,2017,4,263,612,11,886,0.29683972911963900,0.29683972911963900
2017-04-22,2017,4,175,532,18,725,0.2413793103448280,0.2413793103448280
2017-04-23,2017,4,139,424,27,590,0.23559322033898300,0.23559322033898300
2017-04-24,2017,4,236,473,16,725,0.3255172413793100,0.3255172413793100
2017-04-25,2017,4,280,547,17,844,0.33175355450237000,0.33175355450237000
2017-04-26,2017,4,323,573,15,911,0.3545554335894620,0.3545554335894620
2017-04-27,2017,4,290,571,22,883,0.32842582106455300,0.32842582106455300
2017-04-28,2017,4,245,549,19,813,0.3013530135301350,0.3013530135301350
2017-04-29,2017,4,170,542,28,740,0.22972972972973000,0.22972972972973000
2017-04-30,2017,4,148,471,26,645,0.22945736434108500,0.22945736434108500
2017-05-01,2017,5,212,414,41,667,0.31784107946027000,0.31784107946027000
2017-05-02,2017,5,324,630,19,973,0.3329907502569370,0.3329907502569370
2017-05-03,2017,5,357,647,18,1022,0.3493150684931510,0.3493150684931510
2017-05-04,2017,5,349,703,19,1071,0.3258636788048550,0.3258636788048550
2017-05-05,2017,5,230,537,20,787,0.29224904701397700,0.29224904701397700
2017-05-06,2017,5,229,559,35,823,0.2782503037667070,0.2782503037667070
2017-05-07,2017,5,183,433,20,636,0.28773584905660400,0.28773584905660400
2017-05-08,2017,5,247,468,20,735,0.3360544217687080,0.3360544217687080
2017-05-09,2017,5,273,560,27,860,0.3174418604651160,0.3174418604651160
2017-05-10,2017,5,397,714,27,1138,0.34885764499121300,0.34885764499121300
2017-05-11,2017,5,296,655,22,973,0.30421377183967100,0.30421377183967100
2017-05-12,2017,5,264,602,25,891,0.2962962962962960,0.2962962962962960
2017-05-13,2017,5,112,409,18,539,0.2077922077922080,0.2077922077922080
2017-05-14,2017,5,92,335,16,443,0.2076749435665910,0.2076749435665910
2017-05-15,2017,5,255,492,13,760,0.3355263157894740,0.3355263157894740
2017-05-16,2017,5,246,618,18,882,0.2789115646258500,0.2789115646258500
2017-05-17,2017,5,393,648,23,1064,0.3693609022556390,0.3693609022556390
2017-05-18,2017,5,349,576,34,959,0.36392075078206500,0.36392075078206500
2017-05-19,2017,5,241,532,24,797,0.30238393977415300,0.30238393977415300
2017-05-20,2017,5,210,489,26,725,0.2896551724137930,0.2896551724137930
2017-05-21,2017,5,157,384,15,556,0.2823741007194250,0.2823741007194250
2017-05-22,2017,5,210,369,4,583,0.3602058319039450,0.3602058319039450
2017-05-23,2017,5,309,626,12,947,0.3262935586061250,0.3262935586061250
2017-05-24,2017,5,356,604,20,980,0.363265306122449,0.363265306122449
2017-05-25,2017,5,280,522,8,810,0.345679012345679,0.345679012345679
2017-05-26,2017,5,236,526,19,781,0.30217669654289400,0.30217669654289400
2017-05-27,2017,5,187,456,21,664,0.2816265060240960,0.2816265060240960
2017-05-28,2017,5,151,352,19,522,0.289272030651341,0.289272030651341
2017-05-29,2017,5,131,370,7,508,0.2578740157480320,0.2578740157480320
2017-05-30,2017,5,279,526,14,819,0.34065934065934100,0.34065934065934100
2017-05-31,2017,5,296,540,16,852,0.3474178403755870,0.3474178403755870
2017-06-01,2017,6,332,697,23,1052,0.3155893536121670,0.3155893536121670
2017-06-02,2017,6,281,508,16,805,0.3490683229813670,0.3490683229813670
2017-06-03,2017,6,185,501,28,714,0.25910364145658300,0.25910364145658300
2017-06-04,2017,6,169,385,15,569,0.29701230228471000,0.29701230228471000
2017-06-05,2017,6,233,446,12,691,0.33719247467438500,0.33719247467438500
2017-06-06,2017,6,323,552,13,888,0.36373873873873900,0.36373873873873900
2017-06-07,2017,6,320,545,13,878,0.36446469248291600,0.36446469248291600
2017-06-08,2017,6,305,557,7,869,0.35097813578826200,0.35097813578826200
2017-06-09,2017,6,259,603,20,882,0.29365079365079400,0.29365079365079400
2017-06-10,2017,6,179,489,36,704,0.25426136363636400,0.25426136363636400
2017-06-11,2017,6,155,402,19,576,0.2690972222222220,0.2690972222222220
2017-06-12,2017,6,175,436,13,624,0.28044871794871800,0.28044871794871800
2017-06-13,2017,6,311,518,11,840,0.37023809523809500,0.37023809523809500
2017-06-14,2017,6,290,574,14,878,0.33029612756264200,0.33029612756264200
2017-06-15,2017,6,309,607,11,927,0.3333333333333330,0.3333333333333330
2017-06-16,2017,6,272,612,22,906,0.30022075055187600,0.30022075055187600
2017-06-17,2017,6,192,474,17,683,0.28111273792093700,0.28111273792093700
2017-06-18,2017,6,157,343,9,509,0.30844793713163100,0.30844793713163100
2017-06-19,2017,6,214,406,31,651,0.32872503840245800,0.32872503840245800
2017-06-20,2017,6,263,561,15,839,0.3134684147794990,0.3134684147794990
2017-06-21,2017,6,378,604,18,1000,0.378,0.378
2017-06-22,2017,6,311,600,16,927,0.3354908306364620,0.3354908306364620
2017-06-23,2017,6,229,507,16,752,0.3045212765957450,0.3045212765957450
2017-06-24,2017,6,142,519,16,677,0.20974889217134400,0.20974889217134400
2017-06-25,2017,6,161,396,26,583,0.27615780445969100,0.27615780445969100
2017-06-26,2017,6,206,439,5,650,0.3169230769230770,0.3169230769230770
2017-06-27,2017,6,276,507,10,793,0.3480453972257250,0.3480453972257250
2017-06-28,2017,6,265,535,15,815,0.32515337423312900,0.32515337423312900
2017-06-29,2017,6,274,536,9,819,0.33455433455433500,0.33455433455433500
2017-06-30,2017,6,216,486,12,714,0.3025210084033610,0.3025210084033610
2017-07-01,2017,7,203,550,19,772,0.26295336787564800,0.26295336787564800
2017-07-02,2017,7,170,469,14,653,0.26033690658499200,0.26033690658499200
2017-07-03,2017,7,203,421,14,638,0.3181818181818180,0.3181818181818180
2017-07-04,2017,7,183,407,12,602,0.30398671096345500,0.30398671096345500
2017-07-05,2017,7,264,555,14,833,0.3169267707082830,0.3169267707082830
2017-07-06,2017,7,359,547,14,920,0.39021739130434800,0.39021739130434800
2017-07-07,2017,7,270,488,11,769,0.3511053315994800,0.3511053315994800
2017-07-08,2017,7,185,464,13,662,0.2794561933534740,0.2794561933534740
2017-07-09,2017,7,157,394,21,572,0.2744755244755250,0.2744755244755250
2017-07-10,2017,7,188,388,2,578,0.32525951557093400,0.32525951557093400
2017-07-11,2017,7,211,324,7,542,0.3892988929889300,0.3892988929889300
2017-07-12,2017,7,330,623,9,962,0.34303534303534300,0.34303534303534300
2017-07-13,2017,7,366,594,13,973,0.3761562178828370,0.3761562178828370
2017-07-14,2017,7,254,520,14,788,0.3223350253807110,0.3223350253807110
2017-07-15,2017,7,221,492,20,733,0.3015006821282400,0.3015006821282400
2017-07-16,2017,7,148,424,23,595,0.24873949579831900,0.24873949579831900
2017-07-17,2017,7,167,441,11,619,0.26978998384491100,0.26978998384491100
2017-07-18,2017,7,348,538,8,894,0.38926174496644300,0.38926174496644300
2017-07-19,2017,7,356,657,12,1025,0.3473170731707320,0.3473170731707320
2017-07-20,2017,7,263,581,11,855,0.30760233918128700,0.30760233918128700
2017-07-21,2017,7,272,539,20,831,0.32731648616125200,0.32731648616125200
2017-07-22,2017,7,201,502,11,714,0.2815126050420170,0.2815126050420170
2017-07-23,2017,7,159,416,10,585,0.2717948717948720,0.2717948717948720
2017-07-24,2017,7,207,424,7,638,0.32445141065830700,0.32445141065830700
2017-07-25,2017,7,295,567,12,874,0.33752860411899300,0.33752860411899300
2017-07-26,2017,7,342,693,14,1049,0.3260247855100100,0.3260247855100100
2017-07-27,2017,7,340,556,12,908,0.3744493392070490,0.3744493392070490
2017-07-28,2017,7,251,483,16,750,0.33466666666666700,0.33466666666666700
2017-07-29,2017,7,203,522,24,749,0.27102803738317800,0.27102803738317800
2017-07-30,2017,7,136,417,17,570,0.23859649122807000,0.23859649122807000
2017-07-31,2017,7,221,367,15,603,0.36650082918739600,0.36650082918739600
2017-08-01,2017,8,279,475,16,770,0.36233766233766200,0.36233766233766200
2017-08-02,2017,8,378,641,11,1030,0.36699029126213600,0.36699029126213600
2017-08-03,2017,8,328,671,21,1020,0.3215686274509800,0.3215686274509800
2017-08-04,2017,8,263,648,18,929,0.2831001076426270,0.2831001076426270
2017-08-05,2017,8,212,437,8,657,0.3226788432267880,0.3226788432267880
2017-08-06,2017,8,148,421,14,583,0.2538593481989710,0.2538593481989710
2017-08-07,2017,8,178,417,10,605,0.29421487603305800,0.29421487603305800
2017-08-08,2017,8,304,656,8,968,0.3140495867768600,0.3140495867768600
2017-08-09,2017,8,343,620,18,981,0.34964322120285400,0.34964322120285400
2017-08-10,2017,8,375,619,17,1011,0.37091988130563800,0.37091988130563800
2017-08-11,2017,8,269,548,7,824,0.32645631067961200,0.32645631067961200
2017-08-12,2017,8,226,479,26,731,0.3091655266757870,0.3091655266757870
2017-08-13,2017,8,129,409,20,558,0.23118279569892500,0.23118279569892500
2017-08-14,2017,8,209,407,6,622,0.3360128617363340,0.3360128617363340
2017-08-15,2017,8,263,472,6,741,0.3549257759784080,0.3549257759784080
2017-08-16,2017,8,352,566,18,936,0.37606837606837600,0.37606837606837600
2017-08-17,2017,8,310,584,18,912,0.3399122807017540,0.3399122807017540
2017-08-18,2017,8,267,491,17,775,0.3445161290322580,0.3445161290322580
2017-08-19,2017,8,212,458,21,691,0.3068017366136040,0.3068017366136040
2017-08-20,2017,8,144,403,13,560,0.2571428571428570,0.2571428571428570
2017-08-21,2017,8,191,404,12,607,0.31466227347611200,0.31466227347611200
2017-08-22,2017,8,278,517,14,809,0.34363411619283100,0.34363411619283100
2017-08-23,2017,8,275,544,5,824,0.3337378640776700,0.3337378640776700
2017-08-24,2017,8,286,549,11,846,0.3380614657210400,0.3380614657210400
2017-08-25,2017,8,231,565,12,808,0.28589108910891100,0.28589108910891100
2017-08-26,2017,8,158,391,12,561,0.2816399286987520,0.2816399286987520
2017-08-27,2017,8,152,387,19,558,0.2724014336917560,0.2724014336917560
2017-08-28,2017,8,193,395,15,603,0.3200663349917080,0.3200663349917080
2017-08-29,2017,8,233,412,9,654,0.3562691131498470,0.3562691131498470
2017-08-30,2017,8,291,570,10,871,0.3340987370838120,0.3340987370838120
2017-08-31,2017,8,293,539,8,840,0.3488095238095240,0.3488095238095240
2017-09-01,2017,9,291,592,7,890,0.32696629213483100,0.32696629213483100
2017-09-02,2017,9,193,504,10,707,0.272984441301273,0.272984441301273
2017-09-03,2017,9,142,364,14,520,0.27307692307692300,0.27307692307692300
2017-09-04,2017,9,139,347,6,492,0.28252032520325200,0.28252032520325200
2017-09-05,2017,9,257,506,58,821,0.31303288672350800,0.31303288672350800
2017-09-06,2017,9,351,607,12,970,0.3618556701030930,0.3618556701030930
2017-09-07,2017,9,336,590,15,941,0.357066950053135,0.357066950053135
2017-09-08,2017,9,294,515,7,816,0.3602941176470590,0.3602941176470590
2017-09-09,2017,9,198,458,14,670,0.2955223880597020,0.2955223880597020
2017-09-10,2017,9,137,371,11,519,0.26396917148362200,0.26396917148362200
2017-09-11,2017,9,208,397,4,609,0.3415435139573070,0.3415435139573070
2017-09-12,2017,9,276,524,16,816,0.3382352941176470,0.3382352941176470
2017-09-13,2017,9,351,630,16,997,0.3520561685055170,0.3520561685055170
2017-09-14,2017,9,343,636,19,998,0.343687374749499,0.343687374749499
2017-09-15,2017,9,255,545,15,815,0.3128834355828220,0.3128834355828220
2017-09-16,2017,9,186,470,14,670,0.27761194029850700,0.27761194029850700
2017-09-17,2017,9,116,406,15,537,0.21601489757914300,0.21601489757914300
2017-09-18,2017,9,194,359,15,568,0.3415492957746480,0.3415492957746480
2017-09-19,2017,9,220,421,12,653,0.33690658499234300,0.33690658499234300
2017-09-20,2017,9,294,537,10,841,0.34958382877526800,0.34958382877526800
2017-09-21,2017,9,284,594,16,894,0.31767337807606300,0.31767337807606300
2017-09-22,2017,9,226,511,12,749,0.30173564753004000,0.30173564753004000
2017-09-23,2017,9,197,486,17,700,0.2814285714285710,0.2814285714285710
2017-09-24,2017,9,162,427,10,599,0.2704507512520870,0.2704507512520870
2017-09-25,2017,9,204,369,3,576,0.3541666666666670,0.3541666666666670
2017-09-26,2017,9,260,494,7,761,0.3416557161629440,0.3416557161629440
2017-09-27,2017,9,300,568,11,879,0.3412969283276450,0.3412969283276450
2017-09-28,2017,9,296,574,9,879,0.33674630261661000,0.33674630261661000
2017-09-29,2017,9,248,533,15,796,0.31155778894472400,0.31155778894472400
2017-09-30,2017,9,177,491,16,684,0.25877192982456100,0.25877192982456100
2017-10-01,2017,10,143,424,8,575,0.24869565217391300,0.24869565217391300
2017-10-02,2017,10,227,459,6,692,0.32803468208092500,0.32803468208092500
2017-10-03,2017,10,339,597,13,949,0.35721812434141200,0.35721812434141200
2017-10-04,2017,10,373,595,12,980,0.3806122448979590,0.3806122448979590
2017-10-05,2017,10,330,593,17,940,0.35106382978723400,0.35106382978723400
2017-10-06,2017,10,262,610,14,886,0.29571106094808100,0.29571106094808100
2017-10-07,2017,10,211,489,11,711,0.2967651195499300,0.2967651195499300
2017-10-08,2017,10,144,416,14,574,0.2508710801393730,0.2508710801393730
2017-10-09,2017,10,191,396,11,598,0.3193979933110370,0.3193979933110370
2017-10-10,2017,10,310,605,7,922,0.3362255965292840,0.3362255965292840
2017-10-11,2017,10,375,607,16,998,0.375751503006012,0.375751503006012
2017-10-12,2017,10,304,635,15,954,0.31865828092243200,0.31865828092243200
2017-10-13,2017,10,365,551,18,934,0.39079229122055700,0.39079229122055700
2017-10-14,2017,10,208,538,16,762,0.27296587926509200,0.27296587926509200
2017-10-15,2017,10,180,432,15,627,0.28708133971291900,0.28708133971291900
2017-10-16,2017,10,219,415,7,641,0.3416536661466460,0.3416536661466460
2017-10-17,2017,10,242,534,10,786,0.30788804071246800,0.30788804071246800
2017-10-18,2017,10,344,628,11,983,0.34994913530010200,0.34994913530010200
2017-10-19,2017,10,391,616,15,1022,0.38258317025440300,0.38258317025440300
2017-10-20,2017,10,281,594,9,884,0.3178733031674210,0.3178733031674210
2017-10-21,2017,10,198,543,19,760,0.26052631578947400,0.26052631578947400
2017-10-22,2017,10,147,419,12,578,0.25432525951557100,0.25432525951557100
2017-10-23,2017,10,247,450,6,703,0.35135135135135100,0.35135135135135100
2017-10-24,2017,10,338,523,11,872,0.3876146788990830,0.3876146788990830
2017-10-25,2017,10,385,694,9,1088,0.3538602941176470,0.3538602941176470
2017-10-26,2017,10,314,586,16,916,0.34279475982532800,0.34279475982532800
2017-10-27,2017,10,251,521,10,782,0.3209718670076730,0.3209718670076730
2017-10-28,2017,10,169,524,11,704,0.24005681818181800,0.24005681818181800
2017-10-29,2017,10,124,365,6,495,0.2505050505050510,0.2505050505050510
2017-10-30,2017,10,207,379,10,596,0.34731543624161100,0.34731543624161100
2017-10-31,2017,10,235,351,15,601,0.3910149750415970,0.3910149750415970
2017-11-01,2017,11,422,589,7,1018,0.41453831041257400,0.41453831041257400
2017-11-02,2017,11,418,642,22,1082,0.38632162661737500,0.38632162661737500
2017-11-03,2017,11,322,580,11,913,0.35268346111719600,0.35268346111719600
2017-11-04,2017,11,187,493,10,690,0.2710144927536230,0.2710144927536230
2017-11-05,2017,11,126,362,15,503,0.2504970178926440,0.2504970178926440
2017-11-06,2017,11,236,491,7,734,0.3215258855585830,0.3215258855585830
2017-11-07,2017,11,240,458,10,708,0.3389830508474580,0.3389830508474580
2017-11-08,2017,11,306,611,11,928,0.3297413793103450,0.3297413793103450
2017-11-09,2017,11,305,606,10,921,0.3311617806731810,0.3311617806731810
2017-11-10,2017,11,239,539,11,789,0.302915082382763,0.302915082382763
2017-11-11,2017,11,172,468,13,653,0.26339969372128600,0.26339969372128600
2017-11-12,2017,11,135,442,11,588,0.22959183673469400,0.22959183673469400
2017-11-13,2017,11,237,498,5,740,0.3202702702702700,0.3202702702702700
2017-11-14,2017,11,324,567,7,898,0.36080178173719400,0.36080178173719400
2017-11-15,2017,11,351,667,9,1027,0.34177215189873400,0.34177215189873400
2017-11-16,2017,11,293,567,17,877,0.33409350057012500,0.33409350057012500
2017-11-17,2017,11,226,592,13,831,0.2719614921780990,0.2719614921780990
2017-11-18,2017,11,202,502,13,717,0.28172942817294300,0.28172942817294300
2017-11-19,2017,11,171,414,9,594,0.2878787878787880,0.2878787878787880
2017-11-20,2017,11,180,444,5,629,0.2861685214626390,0.2861685214626390
2017-11-21,2017,11,285,530,7,822,0.3467153284671530,0.3467153284671530
2017-11-22,2017,11,245,480,8,733,0.33424283765347900,0.33424283765347900
2017-11-23,2017,11,70,157,1,228,0.30701754385964900,0.30701754385964900
2017-11-24,2017,11,224,481,8,713,0.3141654978962130,0.3141654978962130
2017-11-25,2017,11,181,509,8,698,0.2593123209169050,0.2593123209169050
2017-11-26,2017,11,128,398,13,539,0.23747680890538000,0.23747680890538000
2017-11-27,2017,11,227,394,18,639,0.35524256651017200,0.35524256651017200
2017-11-28,2017,11,287,547,3,837,0.3428912783751490,0.3428912783751490
2017-11-29,2017,11,340,557,7,904,0.37610619469026500,0.37610619469026500
2017-11-30,2017,11,274,564,18,856,0.32009345794392500,0.32009345794392500
2017-12-01,2017,12,250,559,10,819,0.3052503052503050,0.3052503052503050
2017-12-02,2017,12,217,524,13,754,0.28779840848806400,0.28779840848806400
2017-12-03,2017,12,160,412,8,580,0.27586206896551700,0.27586206896551700
2017-12-04,2017,12,242,460,7,709,0.34132581100141000,0.34132581100141000
2017-12-05,2017,12,295,543,9,847,0.3482880755608030,0.3482880755608030
2017-12-06,2017,12,331,558,9,898,0.3685968819599110,0.3685968819599110
2017-12-07,2017,12,327,540,3,870,0.3758620689655170,0.3758620689655170
2017-12-08,2017,12,232,569,7,808,0.2871287128712870,0.2871287128712870
2017-12-09,2017,12,159,439,6,604,0.2632450331125830,0.2632450331125830
2017-12-10,2017,12,133,388,11,532,0.25,0.25
2017-12-11,2017,12,200,389,20,609,0.3284072249589490,0.3284072249589490
2017-12-12,2017,12,283,527,5,815,0.347239263803681,0.347239263803681
2017-12-13,2017,12,289,505,5,799,0.3617021276595750,0.3617021276595750
2017-12-14,2017,12,214,450,8,672,0.31845238095238100,0.31845238095238100
2017-12-15,2017,12,189,444,5,638,0.2962382445141070,0.2962382445141070
2017-12-16,2017,12,170,481,12,663,0.2564102564102560,0.2564102564102560
2017-12-17,2017,12,157,456,15,628,0.25,0.25
2017-12-18,2017,12,215,407,9,631,0.34072900158478600,0.34072900158478600
2017-12-19,2017,12,242,547,23,812,0.29802955665024600,0.29802955665024600
2017-12-20,2017,12,292,573,10,875,0.33371428571428600,0.33371428571428600
2017-12-21,2017,12,231,427,6,664,0.34789156626506000,0.34789156626506000
2017-12-22,2017,12,207,399,6,612,0.3382352941176470,0.3382352941176470
2017-12-23,2017,12,142,385,9,536,0.26492537313432800,0.26492537313432800
2017-12-24,2017,12,90,190,5,285,0.3157894736842110,0.3157894736842110
2017-12-25,2017,12,55,105,0,160,0.34375,0.34375
2017-12-26,2017,12,186,416,7,609,0.3054187192118230,0.3054187192118230
2017-12-27,2017,12,196,435,5,636,0.3081761006289310,0.3081761006289310
2017-12-28,2017,12,236,425,2,663,0.3559577677224740,0.3559577677224740
2017-12-29,2017,12,154,401,6,561,0.27450980392156900,0.27450980392156900
2017-12-30,2017,12,144,330,5,479,0.30062630480167000,0.30062630480167000
2017-12-31,2017,12,110,240,3,353,0.311614730878187,0.311614730878187
2018-01-01,2018,1,150,302,0,452,0.33185840707964600,0.33185840707964600
2018-01-02,2018,1,229,488,3,720,0.31805555555555600,0.31805555555555600
2018-01-03,2018,1,323,574,6,903,0.3576965669988930,0.3576965669988930
2018-01-04,2018,1,116,202,1,319,0.36363636363636400,0.36363636363636400
2018-01-05,2018,1,161,367,2,530,0.30377358490566000,0.30377358490566000
2018-01-06,2018,1,162,327,4,493,0.3286004056795130,0.3286004056795130
2018-01-07,2018,1,100,329,5,434,0.2304147465437790,0.2304147465437790
2018-01-08,2018,1,221,397,5,623,0.3547351524879620,0.3547351524879620
2018-01-09,2018,1,384,550,6,940,0.4085106382978720,0.4085106382978720
2018-01-10,2018,1,335,586,12,933,0.3590568060021440,0.3590568060021440
2018-01-11,2018,1,371,667,26,1064,0.34868421052631600,0.34868421052631600
2018-01-12,2018,1,242,548,10,800,0.3025,0.3025
2018-01-13,2018,1,194,490,13,697,0.2783357245337160,0.2783357245337160
2018-01-14,2018,1,134,434,12,580,0.23103448275862100,0.23103448275862100
2018-01-15,2018,1,219,500,12,731,0.29958960328317400,0.29958960328317400
2018-01-16,2018,1,341,586,6,933,0.3654876741693460,0.3654876741693460
2018-01-17,2018,1,292,633,10,935,0.3122994652406420,0.3122994652406420
2018-01-18,2018,1,350,629,10,989,0.3538928210313450,0.3538928210313450
2018-01-19,2018,1,268,610,5,883,0.3035107587768970,0.3035107587768970
2018-01-20,2018,1,207,589,12,808,0.2561881188118810,0.2561881188118810
2018-01-21,2018,1,131,500,13,644,0.20341614906832300,0.20341614906832300
2018-01-22,2018,1,238,506,7,751,0.3169107856191740,0.3169107856191740
2018-01-23,2018,1,296,627,13,936,0.3162393162393160,0.3162393162393160
2018-01-24,2018,1,364,654,9,1027,0.35443037974683500,0.35443037974683500
2018-01-25,2018,1,281,562,12,855,0.3286549707602340,0.3286549707602340
2018-01-26,2018,1,304,638,13,955,0.3183246073298430,0.3183246073298430
2018-01-27,2018,1,231,539,11,781,0.29577464788732400,0.29577464788732400
2018-01-28,2018,1,140,383,11,534,0.26217228464419500,0.26217228464419500
2018-01-29,2018,1,210,469,9,688,0.30523255813953500,0.30523255813953500
2018-01-30,2018,1,286,512,24,822,0.34793187347931900,0.34793187347931900
2018-01-31,2018,1,310,571,12,893,0.3471444568868980,0.3471444568868980
2018-02-01,2018,2,384,665,7,1056,0.36363636363636400,0.36363636363636400
2018-02-02,2018,2,232,503,6,741,0.31309041835357600,0.31309041835357600
2018-02-03,2018,2,179,537,9,725,0.24689655172413800,0.24689655172413800
2018-02-04,2018,2,138,321,11,470,0.2936170212765960,0.2936170212765960
2018-02-05,2018,2,217,408,3,628,0.34554140127388500,0.34554140127388500
2018-02-06,2018,2,334,524,8,866,0.3856812933025400,0.3856812933025400
2018-02-07,2018,2,329,511,5,845,0.3893491124260360,0.3893491124260360
2018-02-08,2018,2,370,597,13,980,0.37755102040816300,0.37755102040816300
2018-02-09,2018,2,307,522,11,840,0.36547619047619000,0.36547619047619000
2018-02-10,2018,2,210,495,8,713,0.29453015427770000,0.29453015427770000
2018-02-11,2018,2,124,411,5,540,0.22962962962963000,0.22962962962963000
2018-02-12,2018,2,213,482,5,700,0.30428571428571400,0.30428571428571400
2018-02-13,2018,2,367,586,13,966,0.37991718426501000,0.37991718426501000
2018-02-14,2018,2,316,588,8,912,0.34649122807017500,0.34649122807017500
2018-02-15,2018,2,355,620,12,987,0.3596757852077000,0.3596757852077000
2018-02-16,2018,2,241,482,21,744,0.3239247311827960,0.3239247311827960
2018-02-17,2018,2,146,459,12,617,0.2366288492706650,0.2366288492706650
2018-02-18,2018,2,130,387,6,523,0.248565965583174,0.248565965583174
2018-02-19,2018,2,157,487,6,650,0.24153846153846200,0.24153846153846200
2018-02-20,2018,2,290,579,14,883,0.32842582106455300,0.32842582106455300
2018-02-21,2018,2,383,612,15,1010,0.3792079207920790,0.3792079207920790
2018-02-22,2018,2,289,531,11,831,0.34777376654633000,0.34777376654633000
2018-02-23,2018,2,266,509,7,782,0.340153452685422,0.340153452685422
2018-02-24,2018,2,192,470,12,674,0.28486646884273,0.28486646884273
2018-02-25,2018,2,114,381,5,500,0.228,0.228
2018-02-26,2018,2,203,452,8,663,0.30618401206636500,0.30618401206636500
2018-02-27,2018,2,275,472,8,755,0.36423841059602600,0.36423841059602600
2018-02-28,2018,2,286,569,17,872,0.32798165137614700,0.32798165137614700
2018-03-01,2018,3,307,663,10,980,0.31326530612244900,0.31326530612244900
2018-03-02,2018,3,189,345,9,543,0.34806629834254100,0.34806629834254100
2018-03-03,2018,3,203,459,18,680,0.2985294117647060,0.2985294117647060
2018-03-04,2018,3,153,394,3,550,0.2781818181818180,0.2781818181818180
2018-03-05,2018,3,194,447,3,644,0.30124223602484500,0.30124223602484500
2018-03-06,2018,3,347,590,8,945,0.3671957671957670,0.3671957671957670
2018-03-07,2018,3,182,316,8,506,0.35968379446640300,0.35968379446640300
2018-03-08,2018,3,285,517,8,810,0.35185185185185200,0.35185185185185200
2018-03-09,2018,3,411,518,5,934,0.4400428265524630,0.4400428265524630
2018-03-10,2018,3,200,487,14,701,0.28530670470756100,0.28530670470756100
2018-03-11,2018,3,125,429,5,559,0.22361359570661900,0.22361359570661900
2018-03-12,2018,3,241,423,7,671,0.3591654247391950,0.3591654247391950
2018-03-13,2018,3,319,452,5,776,0.4110824742268040,0.4110824742268040
2018-03-14,2018,3,365,535,13,913,0.39978094194961700,0.39978094194961700
2018-03-15,2018,3,295,557,14,866,0.3406466512702080,0.3406466512702080
2018-03-16,2018,3,264,488,7,759,0.34782608695652200,0.34782608695652200
2018-03-17,2018,3,169,511,8,688,0.24563953488372100,0.24563953488372100
2018-03-18,2018,3,136,437,10,583,0.2332761578044600,0.2332761578044600
2018-03-19,2018,3,237,409,1,647,0.366306027820711,0.366306027820711
2018-03-20,2018,3,266,572,6,844,0.31516587677725100,0.31516587677725100
2018-03-21,2018,3,152,312,3,467,0.32548179871520300,0.32548179871520300
2018-03-22,2018,3,258,455,2,715,0.36083916083916100,0.36083916083916100
2018-03-23,2018,3,240,549,4,793,0.3026481715006310,0.3026481715006310
2018-03-24,2018,3,194,442,18,654,0.2966360856269110,0.2966360856269110
2018-03-25,2018,3,124,423,9,556,0.22302158273381300,0.22302158273381300
2018-03-26,2018,3,193,404,4,601,0.3211314475873540,0.3211314475873540
2018-03-27,2018,3,336,519,10,865,0.3884393063583820,0.3884393063583820
2018-03-28,2018,3,286,580,18,884,0.3235294117647060,0.3235294117647060
2018-03-29,2018,3,289,555,13,857,0.3372228704784130,0.3372228704784130
2018-03-30,2018,3,215,429,7,651,0.3302611367127500,0.3302611367127500
2018-03-31,2018,3,167,425,13,605,0.27603305785124000,0.27603305785124000
2018-04-01,2018,4,136,294,7,437,0.3112128146453090,0.3112128146453090
2018-04-02,2018,4,186,365,5,556,0.3345323741007190,0.3345323741007190
2018-04-03,2018,4,266,448,10,724,0.3674033149171270,0.3674033149171270
2018-04-04,2018,4,267,519,14,800,0.33375,0.33375
2018-04-05,2018,4,292,514,13,819,0.35653235653235700,0.35653235653235700
2018-04-06,2018,4,267,508,11,786,0.33969465648855000,0.33969465648855000
2018-04-07,2018,4,211,469,10,690,0.30579710144927500,0.30579710144927500
2018-04-08,2018,4,133,360,11,504,0.2638888888888890,0.2638888888888890
2018-04-09,2018,4,210,404,6,620,0.3387096774193550,0.3387096774193550
2018-04-10,2018,4,364,502,5,871,0.417910447761194,0.417910447761194
2018-04-11,2018,4,340,498,8,846,0.40189125295508300,0.40189125295508300
2018-04-12,2018,4,322,608,13,943,0.34146341463414600,0.34146341463414600
2018-04-13,2018,4,269,488,19,776,0.34664948453608200,0.34664948453608200
2018-04-14,2018,4,200,475,19,694,0.2881844380403460,0.2881844380403460
2018-04-15,2018,4,158,375,6,539,0.29313543599257900,0.29313543599257900
2018-04-16,2018,4,165,325,9,499,0.3306613226452910,0.3306613226452910
2018-04-17,2018,4,300,481,7,788,0.38071065989847700,0.38071065989847700
2018-04-18,2018,4,337,528,10,875,0.3851428571428570,0.3851428571428570
2018-04-19,2018,4,315,513,7,835,0.3772455089820360,0.3772455089820360
2018-04-20,2018,4,262,482,6,750,0.34933333333333300,0.34933333333333300
2018-04-21,2018,4,197,445,11,653,0.3016845329249620,0.3016845329249620
2018-04-22,2018,4,142,374,9,525,0.2704761904761910,0.2704761904761910
2018-04-23,2018,4,248,352,11,611,0.40589198036006500,0.40589198036006500
2018-04-24,2018,4,250,529,17,796,0.314070351758794,0.314070351758794
2018-04-25,2018,4,438,485,11,934,0.4689507494646680,0.4689507494646680
2018-04-26,2018,4,307,508,28,843,0.3641755634638200,0.3641755634638200
2018-04-27,2018,4,243,472,9,724,0.3356353591160220,0.3356353591160220
2018-04-28,2018,4,163,467,8,638,0.2554858934169280,0.2554858934169280
2018-04-29,2018,4,143,378,9,530,0.269811320754717,0.269811320754717
2018-04-30,2018,4,196,342,10,548,0.35766423357664200,0.35766423357664200
2018-05-01,2018,5,352,487,3,842,0.4180522565320670,0.4180522565320670
2018-05-02,2018,5,359,606,17,982,0.3655804480651730,0.3655804480651730
2018-05-03,2018,5,293,527,13,833,0.3517406962785110,0.3517406962785110
2018-05-04,2018,5,285,522,13,820,0.3475609756097560,0.3475609756097560
2018-05-05,2018,5,179,462,16,657,0.2724505327245050,0.2724505327245050
2018-05-06,2018,5,173,380,3,556,0.31115107913669100,0.31115107913669100
2018-05-07,2018,5,222,371,11,604,0.3675496688741720,0.3675496688741720
2018-05-08,2018,5,280,504,11,795,0.3522012578616350,0.3522012578616350
2018-05-09,2018,5,279,530,8,817,0.34149326805385600,0.34149326805385600
2018-05-10,2018,5,342,497,7,846,0.40425531914893600,0.40425531914893600
2018-05-11,2018,5,259,561,13,833,0.31092436974789900,0.31092436974789900
2018-05-12,2018,5,204,428,12,644,0.3167701863354040,0.3167701863354040
2018-05-13,2018,5,128,330,5,463,0.27645788336933000,0.27645788336933000
2018-05-14,2018,5,180,433,11,624,0.28846153846153800,0.28846153846153800
2018-05-15,2018,5,208,412,10,630,0.33015873015873000,0.33015873015873000
2018-05-16,2018,5,283,484,8,775,0.36516129032258100,0.36516129032258100
2018-05-17,2018,5,348,471,7,826,0.4213075060532690,0.4213075060532690
2018-05-18,2018,5,258,494,16,768,0.3359375,0.3359375
2018-05-19,2018,5,157,339,14,510,0.307843137254902,0.307843137254902
2018-05-20,2018,5,189,363,8,560,0.3375,0.3375
2018-05-21,2018,5,193,436,7,636,0.30345911949685500,0.30345911949685500
2018-05-22,2018,5,266,409,14,689,0.386066763425254,0.386066763425254
2018-05-23,2018,5,375,492,16,883,0.4246885617214040,0.4246885617214040
2018-05-24,2018,5,296,452,16,764,0.387434554973822,0.387434554973822
2018-05-25,2018,5,269,463,14,746,0.3605898123324400,0.3605898123324400
2018-05-26,2018,5,221,358,12,591,0.3739424703891710,0.3739424703891710
2018-05-27,2018,5,121,343,8,472,0.2563559322033900,0.2563559322033900
2018-05-28,2018,5,128,286,4,418,0.3062200956937800,0.3062200956937800
2018-05-29,2018,5,272,463,12,747,0.36412315930388200,0.36412315930388200
2018-05-30,2018,5,329,441,8,778,0.42287917737789200,0.42287917737789200
2018-05-31,2018,5,282,435,8,725,0.3889655172413790,0.3889655172413790
2018-06-01,2018,6,282,417,12,711,0.39662447257384000,0.39662447257384000
2018-06-02,2018,6,200,402,14,616,0.3246753246753250,0.3246753246753250
2018-06-03,2018,6,157,308,4,469,0.3347547974413650,0.3347547974413650
2018-06-04,2018,6,260,344,7,611,0.425531914893617,0.425531914893617
2018-06-05,2018,6,286,451,7,744,0.3844086021505380,0.3844086021505380
2018-06-06,2018,6,296,476,5,777,0.38095238095238100,0.38095238095238100
2018-06-07,2018,6,288,467,8,763,0.37745740498034100,0.37745740498034100
2018-06-08,2018,6,231,434,15,680,0.3397058823529410,0.3397058823529410
2018-06-09,2018,6,195,422,9,626,0.31150159744408900,0.31150159744408900
2018-06-10,2018,6,125,313,9,447,0.2796420581655480,0.2796420581655480
2018-06-11,2018,6,179,361,4,544,0.3290441176470590,0.3290441176470590
2018-06-12,2018,6,277,455,6,738,0.37533875338753400,0.37533875338753400
2018-06-13,2018,6,273,426,11,710,0.3845070422535210,0.3845070422535210
2018-06-14,2018,6,302,416,11,729,0.41426611796982200,0.41426611796982200
2018-06-15,2018,6,234,419,10,663,0.35294117647058800,0.35294117647058800
2018-06-16,2018,6,182,418,13,613,0.2969004893964110,0.2969004893964110
2018-06-17,2018,6,129,329,10,468,0.27564102564102600,0.27564102564102600
2018-06-18,2018,6,234,340,4,578,0.40484429065743900,0.40484429065743900
2018-06-19,2018,6,303,411,7,721,0.420249653259362,0.420249653259362
2018-06-20,2018,6,347,474,19,840,0.41309523809523800,0.41309523809523800
2018-06-21,2018,6,320,574,6,900,0.35555555555555600,0.35555555555555600
2018-06-22,2018,6,217,417,9,643,0.33748055987558300,0.33748055987558300
2018-06-23,2018,6,158,428,5,591,0.2673434856175970,0.2673434856175970
2018-06-24,2018,6,142,291,4,437,0.32494279176201400,0.32494279176201400
2018-06-25,2018,6,213,286,5,504,0.4226190476190480,0.4226190476190480
2018-06-26,2018,6,252,388,4,644,0.391304347826087,0.391304347826087
2018-06-27,2018,6,335,429,10,774,0.43281653746770000,0.43281653746770000
2018-06-28,2018,6,261,393,10,664,0.3930722891566270,0.3930722891566270
2018-06-29,2018,6,235,394,12,641,0.3666146645865840,0.3666146645865840
2018-06-30,2018,6,161,347,10,518,0.3108108108108110,0.3108108108108110
2018-07-01,2018,7,147,308,13,468,0.3141025641025640,0.3141025641025640
2018-07-02,2018,7,229,294,3,526,0.435361216730038,0.435361216730038
2018-07-03,2018,7,253,435,15,703,0.35988620199146500,0.35988620199146500
2018-07-04,2018,7,166,400,23,589,0.28183361629881200,0.28183361629881200
2018-07-05,2018,7,309,433,5,747,0.41365461847389600,0.41365461847389600
2018-07-06,2018,7,293,471,13,777,0.3770913770913770,0.3770913770913770
2018-07-07,2018,7,198,434,19,651,0.30414746543778800,0.30414746543778800
2018-07-08,2018,7,137,347,13,497,0.27565392354124700,0.27565392354124700
2018-07-09,2018,7,202,384,4,590,0.3423728813559320,0.3423728813559320
2018-07-10,2018,7,262,442,14,718,0.3649025069637880,0.3649025069637880
2018-07-11,2018,7,298,475,9,782,0.38107416879795400,0.38107416879795400
2018-07-12,2018,7,263,492,14,769,0.3420026007802340,0.3420026007802340
2018-07-13,2018,7,259,435,10,704,0.3678977272727270,0.3678977272727270
2018-07-14,2018,7,213,450,7,670,0.31791044776119400,0.31791044776119400
2018-07-15,2018,7,165,392,6,563,0.29307282415630600,0.29307282415630600
2018-07-16,2018,7,254,382,11,647,0.39258114374034000,0.39258114374034000
2018-07-17,2018,7,302,405,10,717,0.4211994421199440,0.4211994421199440
2018-07-18,2018,7,338,496,6,840,0.4023809523809520,0.4023809523809520
2018-07-19,2018,7,280,424,14,718,0.38997214484679700,0.38997214484679700
2018-07-20,2018,7,252,470,13,735,0.34285714285714300,0.34285714285714300
2018-07-21,2018,7,191,459,8,658,0.29027355623100300,0.29027355623100300
2018-07-22,2018,7,111,371,10,492,0.22560975609756100,0.22560975609756100
2018-07-23,2018,7,213,407,9,629,0.3386327503974560,0.3386327503974560
2018-07-24,2018,7,276,470,9,755,0.3655629139072850,0.3655629139072850
2018-07-25,2018,7,274,484,13,771,0.3553826199740600,0.3553826199740600
2018-07-26,2018,7,334,527,14,875,0.38171428571428600,0.38171428571428600
2018-07-27,2018,7,230,429,10,669,0.34379671150971600,0.34379671150971600
2018-07-28,2018,7,189,379,12,580,0.3258620689655170,0.3258620689655170
2018-07-29,2018,7,174,403,11,588,0.29591836734693900,0.29591836734693900
2018-07-30,2018,7,212,339,3,554,0.38267148014440400,0.38267148014440400
2018-07-31,2018,7,298,393,13,704,0.42329545454545500,0.42329545454545500
2018-08-01,2018,8,373,475,8,856,0.4357476635514020,0.4357476635514020
2018-08-02,2018,8,316,448,12,776,0.4072164948453610,0.4072164948453610
2018-08-03,2018,8,286,480,6,772,0.3704663212435230,0.3704663212435230
2018-08-04,2018,8,187,400,10,597,0.3132328308207710,0.3132328308207710
2018-08-05,2018,8,168,380,11,559,0.3005366726296960,0.3005366726296960
2018-08-06,2018,8,221,375,8,604,0.3658940397350990,0.3658940397350990
2018-08-07,2018,8,283,422,7,712,0.39747191011236000,0.39747191011236000
2018-08-08,2018,8,352,486,10,848,0.41509433962264200,0.41509433962264200
2018-08-09,2018,8,310,472,7,789,0.3929024081115340,0.3929024081115340
2018-08-10,2018,8,255,435,7,697,0.36585365853658500,0.36585365853658500
2018-08-11,2018,8,189,405,8,602,0.313953488372093,0.313953488372093
2018-08-12,2018,8,146,395,8,549,0.2659380692167580,0.2659380692167580
2018-08-13,2018,8,200,319,6,525,0.38095238095238100,0.38095238095238100
2018-08-14,2018,8,291,428,2,721,0.40360610263522900,0.40360610263522900
2018-08-15,2018,8,329,440,11,780,0.4217948717948720,0.4217948717948720
2018-08-16,2018,8,322,487,3,812,0.39655172413793100,0.39655172413793100
2018-08-17,2018,8,274,454,9,737,0.37177747625508800,0.37177747625508800
2018-08-18,2018,8,192,398,8,598,0.3210702341137120,0.3210702341137120
2018-08-19,2018,8,196,392,9,597,0.32830820770519300,0.32830820770519300
2018-08-20,2018,8,239,362,7,608,0.3930921052631580,0.3930921052631580
2018-08-21,2018,8,301,429,7,737,0.4084124830393490,0.4084124830393490
2018-08-22,2018,8,269,467,43,779,0.3453145057766370,0.3453145057766370
2018-08-23,2018,8,290,404,8,702,0.4131054131054130,0.4131054131054130
2018-08-24,2018,8,289,445,18,752,0.38430851063829800,0.38430851063829800
2018-08-25,2018,8,187,421,11,619,0.30210016155088900,0.30210016155088900
2018-08-26,2018,8,167,319,7,493,0.33874239350912800,0.33874239350912800
2018-08-27,2018,8,204,352,10,566,0.36042402826855100,0.36042402826855100
2018-08-28,2018,8,271,431,12,714,0.3795518207282910,0.3795518207282910
2018-08-29,2018,8,296,452,9,757,0.3910171730515190,0.3910171730515190
2018-08-30,2018,8,270,411,18,699,0.38626609442060100,0.38626609442060100
2018-08-31,2018,8,209,419,9,637,0.3281004709576140,0.3281004709576140
2018-09-01,2018,9,191,465,15,671,0.2846497764530550,0.2846497764530550
2018-09-02,2018,9,178,353,11,542,0.3284132841328410,0.3284132841328410
2018-09-03,2018,9,151,343,5,499,0.3026052104208420,0.3026052104208420
2018-09-04,2018,9,259,391,5,655,0.39541984732824400,0.39541984732824400
2018-09-05,2018,9,284,426,3,713,0.39831697054698500,0.39831697054698500
2018-09-06,2018,9,303,432,7,742,0.408355795148248,0.408355795148248
2018-09-07,2018,9,270,460,9,739,0.36535859269282800,0.36535859269282800
2018-09-08,2018,9,178,346,10,534,0.3333333333333330,0.3333333333333330
2018-09-09,2018,9,126,265,4,395,0.3189873417721520,0.3189873417721520
2018-09-10,2018,9,187,317,6,510,0.36666666666666700,0.36666666666666700
2018-09-11,2018,9,269,418,1,688,0.39098837209302300,0.39098837209302300
2018-09-12,2018,9,353,443,8,804,0.43905472636815900,0.43905472636815900
2018-09-13,2018,9,315,390,10,715,0.4405594405594410,0.4405594405594410
2018-09-14,2018,9,275,432,2,709,0.38787023977433000,0.38787023977433000
2018-09-15,2018,9,171,387,11,569,0.30052724077328600,0.30052724077328600
2018-09-16,2018,9,131,318,6,455,0.2879120879120880,0.2879120879120880
2018-09-17,2018,9,258,356,7,621,0.41545893719806800,0.41545893719806800
2018-09-18,2018,9,296,481,3,780,0.37948717948717900,0.37948717948717900
2018-09-19,2018,9,365,484,8,857,0.425904317386231,0.425904317386231
2018-09-20,2018,9,306,442,9,757,0.404227212681638,0.404227212681638
2018-09-21,2018,9,272,413,5,690,0.39420289855072500,0.39420289855072500
2018-09-22,2018,9,171,357,8,536,0.31902985074626900,0.31902985074626900
2018-09-23,2018,9,139,315,5,459,0.3028322440087150,0.3028322440087150
2018-09-24,2018,9,170,284,16,470,0.3617021276595750,0.3617021276595750
2018-09-25,2018,9,197,250,5,452,0.4358407079646020,0.4358407079646020
2018-09-26,2018,9,234,365,4,603,0.3880597014925370,0.3880597014925370
2018-09-27,2018,9,258,381,6,645,0.4,0.4
2018-09-28,2018,9,231,337,5,573,0.4031413612565450,0.4031413612565450
2018-09-29,2018,9,172,355,7,534,0.32209737827715400,0.32209737827715400
2018-09-30,2018,9,140,288,5,433,0.3233256351039260,0.3233256351039260
2018-10-01,2018,10,181,333,1,515,0.35145631067961200,0.35145631067961200
2018-10-02,2018,10,279,401,4,684,0.40789473684210500,0.40789473684210500
2018-10-03,2018,10,317,455,4,776,0.40850515463917500,0.40850515463917500
2018-10-04,2018,10,285,455,4,744,0.38306451612903200,0.38306451612903200
2018-10-05,2018,10,279,379,5,663,0.42081447963800900,0.42081447963800900
2018-10-06,2018,10,164,279,6,449,0.36525612472160400,0.36525612472160400
2018-10-07,2018,10,149,291,7,447,0.3333333333333330,0.3333333333333330
2018-10-08,2018,10,167,335,0,502,0.33266932270916300,0.33266932270916300
2018-10-09,2018,10,311,463,4,778,0.39974293059126000,0.39974293059126000
2018-10-10,2018,10,339,462,2,803,0.42216687422166900,0.42216687422166900
2018-10-11,2018,10,292,451,3,746,0.3914209115281500,0.3914209115281500
2018-10-12,2018,10,252,408,6,666,0.3783783783783780,0.3783783783783780
2018-10-13,2018,10,177,395,4,576,0.3072916666666670,0.3072916666666670
2018-10-14,2018,10,105,359,2,466,0.22532188841201700,0.22532188841201700
2018-10-15,2018,10,238,312,4,554,0.4296028880866430,0.4296028880866430
2018-10-16,2018,10,313,402,6,721,0.43411927877947300,0.43411927877947300
2018-10-17,2018,10,310,498,6,814,0.3808353808353810,0.3808353808353810
2018-10-18,2018,10,264,402,4,670,0.3940298507462690,0.3940298507462690
2018-10-19,2018,10,251,407,3,661,0.37972768532526500,0.37972768532526500
2018-10-20,2018,10,190,350,7,547,0.3473491773308960,0.3473491773308960
2018-10-21,2018,10,119,313,4,436,0.27293577981651400,0.27293577981651400
2018-10-22,2018,10,225,374,3,602,0.37375415282392000,0.37375415282392000
2018-10-23,2018,10,245,425,7,677,0.361890694239291,0.361890694239291
2018-10-24,2018,10,308,417,7,732,0.4207650273224040,0.4207650273224040
2018-10-25,2018,10,283,424,15,722,0.39196675900277000,0.39196675900277000
2018-10-26,2018,10,249,369,7,625,0.3984,0.3984
2018-10-27,2018,10,146,299,3,448,0.32589285714285700,0.32589285714285700
2018-10-28,2018,10,156,335,6,497,0.31388329979879300,0.31388329979879300
2018-10-29,2018,10,204,332,4,540,0.37777777777777800,0.37777777777777800
2018-10-30,2018,10,271,360,18,649,0.41756548536209600,0.41756548536209600
2018-10-31,2018,10,223,371,3,597,0.37353433835845900,0.37353433835845900
2018-11-01,2018,11,388,484,7,879,0.44141069397042100,0.44141069397042100
2018-11-02,2018,11,247,454,9,710,0.34788732394366200,0.34788732394366200
2018-11-03,2018,11,157,335,6,498,0.3152610441767070,0.3152610441767070
2018-11-04,2018,11,138,294,4,436,0.3165137614678900,0.3165137614678900
2018-11-05,2018,11,175,284,3,462,0.3787878787878790,0.3787878787878790
2018-11-06,2018,11,200,358,4,562,0.35587188612099600,0.35587188612099600
2018-11-07,2018,11,338,429,10,777,0.435006435006435,0.435006435006435
2018-11-08,2018,11,344,440,13,797,0.4316185696361360,0.4316185696361360
2018-11-09,2018,11,233,359,4,596,0.39093959731543600,0.39093959731543600
2018-11-10,2018,11,189,377,5,571,0.3309982486865150,0.3309982486865150
2018-11-11,2018,11,128,336,4,468,0.27350427350427400,0.27350427350427400
2018-11-12,2018,11,207,325,3,535,0.38691588785046700,0.38691588785046700
2018-11-13,2018,11,246,410,1,657,0.3744292237442920,0.3744292237442920
2018-11-14,2018,11,297,435,4,736,0.40353260869565200,0.40353260869565200
2018-11-15,2018,11,232,321,1,554,0.4187725631768950,0.4187725631768950
2018-11-16,2018,11,226,333,3,562,0.40213523131672600,0.40213523131672600
2018-11-17,2018,11,168,356,12,536,0.31343283582089600,0.31343283582089600
2018-11-18,2018,11,159,315,4,478,0.33263598326359800,0.33263598326359800
2018-11-19,2018,11,252,361,4,617,0.40842787682333900,0.40842787682333900
2018-11-20,2018,11,274,395,1,670,0.408955223880597,0.408955223880597
2018-11-21,2018,11,244,364,2,610,0.4,0.4
2018-11-22,2018,11,57,140,0,197,0.2893401015228430,0.2893401015228430
2018-11-23,2018,11,215,394,3,612,0.35130718954248400,0.35130718954248400
2018-11-24,2018,11,150,329,5,484,0.30991735537190100,0.30991735537190100
2018-11-25,2018,11,136,320,9,465,0.2924731182795700,0.2924731182795700
2018-11-26,2018,11,192,301,5,498,0.3855421686746990,0.3855421686746990
2018-11-27,2018,11,317,393,6,716,0.44273743016759800,0.44273743016759800
2018-11-28,2018,11,298,416,4,718,0.415041782729805,0.415041782729805
2018-11-29,2018,11,317,471,3,791,0.40075853350189600,0.40075853350189600
2018-11-30,2018,11,231,411,2,644,0.358695652173913,0.358695652173913
2018-12-01,2018,12,177,431,3,611,0.2896890343698850,0.2896890343698850
2018-12-02,2018,12,140,290,0,430,0.32558139534883700,0.32558139534883700
2018-12-03,2018,12,245,372,2,619,0.39579967689822300,0.39579967689822300
2018-12-04,2018,12,301,410,5,716,0.420391061452514,0.420391061452514
2018-12-05,2018,12,306,422,5,733,0.417462482946794,0.417462482946794
2018-12-06,2018,12,301,463,5,769,0.3914174252275680,0.3914174252275680
2018-12-07,2018,12,221,477,10,708,0.3121468926553670,0.3121468926553670
2018-12-08,2018,12,193,407,2,602,0.32059800664451800,0.32059800664451800
2018-12-09,2018,12,132,319,6,457,0.2888402625820570,0.2888402625820570
2018-12-10,2018,12,204,324,24,552,0.3695652173913040,0.3695652173913040
2018-12-11,2018,12,358,403,4,765,0.46797385620915000,0.46797385620915000
2018-12-12,2018,12,312,469,3,784,0.3979591836734690,0.3979591836734690
2018-12-13,2018,12,249,357,2,608,0.4095394736842110,0.4095394736842110
2018-12-14,2018,12,240,426,5,671,0.35767511177347200,0.35767511177347200
2018-12-15,2018,12,183,394,3,580,0.31551724137931000,0.31551724137931000
2018-12-16,2018,12,110,255,2,367,0.2997275204359670,0.2997275204359670
2018-12-17,2018,12,194,299,4,497,0.3903420523138830,0.3903420523138830
2018-12-18,2018,12,286,368,5,659,0.4339908952959030,0.4339908952959030
2018-12-19,2018,12,250,392,2,644,0.38819875776397500,0.38819875776397500
2018-12-20,2018,12,237,369,9,615,0.3853658536585370,0.3853658536585370
2018-12-21,2018,12,199,361,3,563,0.35346358792184700,0.35346358792184700
2018-12-22,2018,12,162,338,2,502,0.32270916334661400,0.32270916334661400
2018-12-23,2018,12,129,284,4,417,0.30935251798561200,0.30935251798561200
2018-12-24,2018,12,99,177,6,282,0.35106382978723400,0.35106382978723400
2018-12-25,2018,12,72,123,1,196,0.3673469387755100,0.3673469387755100
2018-12-26,2018,12,197,305,4,506,0.3893280632411070,0.3893280632411070
2018-12-27,2018,12,233,394,5,632,0.3686708860759490,0.3686708860759490
2018-12-28,2018,12,199,322,2,523,0.38049713193116600,0.38049713193116600
2018-12-29,2018,12,172,351,7,530,0.32452830188679200,0.32452830188679200
2018-12-30,2018,12,129,286,4,419,0.30787589498806700,0.30787589498806700
2018-12-31,2018,12,102,196,2,300,0.34,0.34
2019-01-01,2019,1,206,336,5,547,0.376599634369287,0.376599634369287
2019-01-02,2019,1,277,432,18,727,0.3810178817056400,0.3810178817056400
2019-01-03,2019,1,317,479,5,801,0.39575530586766500,0.39575530586766500
2019-01-04,2019,1,285,472,18,775,0.36774193548387100,0.36774193548387100
2019-01-05,2019,1,167,344,8,519,0.3217726396917150,0.3217726396917150
2019-01-06,2019,1,147,322,3,472,0.3114406779661020,0.3114406779661020
2019-01-07,2019,1,239,391,11,641,0.37285491419656800,0.37285491419656800
2019-01-08,2019,1,328,401,6,735,0.44625850340136100,0.44625850340136100
2019-01-09,2019,1,284,423,3,710,0.4,0.4
2019-01-10,2019,1,339,493,12,844,0.40165876777251200,0.40165876777251200
2019-01-11,2019,1,251,403,6,660,0.3803030303030300,0.3803030303030300
2019-01-12,2019,1,195,365,12,572,0.3409090909090910,0.3409090909090910
2019-01-13,2019,1,131,323,8,462,0.28354978354978400,0.28354978354978400
2019-01-14,2019,1,245,338,6,589,0.4159592529711380,0.4159592529711380
2019-01-15,2019,1,305,417,5,727,0.4195323246217330,0.4195323246217330
2019-01-16,2019,1,315,444,14,773,0.407503234152652,0.407503234152652
2019-01-17,2019,1,273,472,13,758,0.36015831134564600,0.36015831134564600
2019-01-18,2019,1,255,466,12,733,0.3478854024556620,0.3478854024556620
2019-01-19,2019,1,187,351,5,543,0.3443830570902390,0.3443830570902390
2019-01-20,2019,1,153,281,3,437,0.3501144164759730,0.3501144164759730
2019-01-21,2019,1,114,265,1,380,0.3,0.3
2019-01-22,2019,1,277,400,11,688,0.40261627906976700,0.40261627906976700
2019-01-23,2019,1,331,497,7,835,0.3964071856287430,0.3964071856287430
2019-01-24,2019,1,273,410,6,689,0.39622641509434000,0.39622641509434000
2019-01-25,2019,1,311,445,10,766,0.40600522193211500,0.40600522193211500
2019-01-26,2019,1,171,427,19,617,0.2771474878444080,0.2771474878444080
2019-01-27,2019,1,147,360,3,510,0.28823529411764700,0.28823529411764700
2019-01-28,2019,1,166,331,6,503,0.33001988071570600,0.33001988071570600
2019-01-29,2019,1,289,383,6,678,0.42625368731563400,0.42625368731563400
2019-01-30,2019,1,289,364,11,664,0.4352409638554220,0.4352409638554220
2019-01-31,2019,1,230,325,6,561,0.40998217468805700,0.40998217468805700
2019-02-01,2019,2,262,415,5,682,0.3841642228739000,0.3841642228739000
2019-02-02,2019,2,207,400,8,615,0.33658536585365900,0.33658536585365900
2019-02-03,2019,2,132,309,4,445,0.2966292134831460,0.2966292134831460
2019-02-04,2019,2,314,406,9,729,0.43072702331961600,0.43072702331961600
2019-02-05,2019,2,305,445,10,760,0.40131578947368400,0.40131578947368400
2019-02-06,2019,2,346,409,8,763,0.4534731323722150,0.4534731323722150
2019-02-07,2019,2,294,442,11,747,0.39357429718875500,0.39357429718875500
2019-02-08,2019,2,244,432,8,684,0.3567251461988300,0.3567251461988300
2019-02-09,2019,2,210,409,9,628,0.3343949044585990,0.3343949044585990
2019-02-10,2019,2,133,333,3,469,0.2835820895522390,0.2835820895522390
2019-02-11,2019,2,210,345,2,557,0.3770197486535010,0.3770197486535010
2019-02-12,2019,2,208,345,8,561,0.37076648841354700,0.37076648841354700
2019-02-13,2019,2,295,428,8,731,0.40355677154582800,0.40355677154582800
2019-02-14,2019,2,251,422,5,678,0.3702064896755160,0.3702064896755160
2019-02-15,2019,2,281,415,27,723,0.38865836791148000,0.38865836791148000
2019-02-16,2019,2,221,424,13,658,0.33586626139817600,0.33586626139817600
2019-02-17,2019,2,143,336,5,484,0.29545454545454500,0.29545454545454500
2019-02-18,2019,2,153,344,6,503,0.30417495029821100,0.30417495029821100
2019-02-19,2019,2,272,381,5,658,0.4133738601823710,0.4133738601823710
2019-02-20,2019,2,123,249,8,380,0.3236842105263160,0.3236842105263160
2019-02-21,2019,2,318,413,13,744,0.4274193548387100,0.4274193548387100
2019-02-22,2019,2,235,441,7,683,0.3440702781844800,0.3440702781844800
2019-02-23,2019,2,179,429,11,619,0.28917609046849800,0.28917609046849800
2019-02-24,2019,2,139,353,6,498,0.2791164658634540,0.2791164658634540
2019-02-25,2019,2,165,332,4,501,0.32934131736526900,0.32934131736526900
2019-02-26,2019,2,190,392,13,595,0.31932773109243700,0.31932773109243700
2019-02-27,2019,2,299,433,13,745,0.40134228187919500,0.40134228187919500
2019-02-28,2019,2,265,446,8,719,0.36856745479833100,0.36856745479833100
2019-03-01,2019,3,262,407,8,677,0.3870014771048740,0.3870014771048740
2019-03-02,2019,3,162,354,9,525,0.30857142857142900,0.30857142857142900
2019-03-03,2019,3,153,351,6,510,0.3,0.3
2019-03-04,2019,3,136,317,9,462,0.2943722943722940,0.2943722943722940
2019-03-05,2019,3,253,443,11,707,0.3578500707213580,0.3578500707213580
2019-03-06,2019,3,293,418,5,716,0.4092178770949720,0.4092178770949720
2019-03-07,2019,3,293,428,8,729,0.401920438957476,0.401920438957476
2019-03-08,2019,3,275,411,7,693,0.3968253968253970,0.3968253968253970
2019-03-09,2019,3,151,430,10,591,0.25549915397631100,0.25549915397631100
2019-03-10,2019,3,148,325,3,476,0.31092436974789900,0.31092436974789900
2019-03-11,2019,3,336,368,9,713,0.47124824684432000,0.47124824684432000
2019-03-12,2019,3,308,432,6,746,0.4128686327077750,0.4128686327077750
2019-03-13,2019,3,326,458,10,794,0.4105793450881610,0.4105793450881610
2019-03-14,2019,3,302,395,11,708,0.4265536723163840,0.4265536723163840
2019-03-15,2019,3,260,398,23,681,0.38179148311306900,0.38179148311306900
2019-03-16,2019,3,184,359,7,550,0.33454545454545500,0.33454545454545500
2019-03-17,2019,3,146,281,6,433,0.3371824480369520,0.3371824480369520
2019-03-18,2019,3,187,350,8,545,0.3431192660550460,0.3431192660550460
2019-03-19,2019,3,278,426,4,708,0.3926553672316380,0.3926553672316380
2019-03-20,2019,3,335,423,13,771,0.4345006485084310,0.4345006485084310
2019-03-21,2019,3,242,374,8,624,0.38782051282051300,0.38782051282051300
2019-03-22,2019,3,256,381,6,643,0.39813374805598800,0.39813374805598800
2019-03-23,2019,3,198,405,7,610,0.32459016393442600,0.32459016393442600
2019-03-24,2019,3,162,342,5,509,0.3182711198428290,0.3182711198428290
2019-03-25,2019,3,211,299,4,514,0.41050583657587500,0.41050583657587500
2019-03-26,2019,3,301,452,6,759,0.3965744400527010,0.3965744400527010
2019-03-27,2019,3,290,409,10,709,0.4090267983074750,0.4090267983074750
2019-03-28,2019,3,305,442,13,760,0.40131578947368400,0.40131578947368400
2019-03-29,2019,3,233,434,9,676,0.34467455621301800,0.34467455621301800
2019-03-30,2019,3,170,332,11,513,0.3313840155945420,0.3313840155945420
2019-03-31,2019,3,123,338,7,468,0.26282051282051300,0.26282051282051300
2019-04-01,2019,4,196,341,7,544,0.3602941176470590,0.3602941176470590
2019-04-02,2019,4,325,402,7,734,0.4427792915531340,0.4427792915531340
2019-04-03,2019,4,352,467,6,825,0.4266666666666670,0.4266666666666670
2019-04-04,2019,4,300,457,13,770,0.38961038961039000,0.38961038961039000
2019-04-05,2019,4,285,410,19,714,0.39915966386554600,0.39915966386554600
2019-04-06,2019,4,196,380,4,580,0.33793103448275900,0.33793103448275900
2019-04-07,2019,4,156,322,4,482,0.3236514522821580,0.3236514522821580
2019-04-08,2019,4,213,336,1,550,0.38727272727272700,0.38727272727272700
2019-04-09,2019,4,373,412,9,794,0.46977329974811100,0.46977329974811100
2019-04-10,2019,4,307,488,7,802,0.3827930174563590,0.3827930174563590
2019-04-11,2019,4,316,457,6,779,0.4056482670089860,0.4056482670089860
2019-04-12,2019,4,270,380,8,658,0.41033434650455900,0.41033434650455900
2019-04-13,2019,4,143,352,7,502,0.2848605577689240,0.2848605577689240
2019-04-14,2019,4,137,354,9,500,0.274,0.274
2019-04-15,2019,4,213,322,3,538,0.395910780669145,0.395910780669145
2019-04-16,2019,4,293,422,6,721,0.406380027739251,0.406380027739251
2019-04-17,2019,4,337,460,72,869,0.3878020713463750,0.3878020713463750
2019-04-18,2019,4,304,409,9,722,0.42105263157894700,0.42105263157894700
2019-04-19,2019,4,232,403,3,638,0.36363636363636400,0.36363636363636400
2019-04-20,2019,4,156,309,13,478,0.3263598326359830,0.3263598326359830
2019-04-21,2019,4,134,295,6,435,0.3080459770114940,0.3080459770114940
2019-04-22,2019,4,161,330,2,493,0.3265720081135900,0.3265720081135900
2019-04-23,2019,4,272,364,16,652,0.4171779141104290,0.4171779141104290
2019-04-24,2019,4,367,425,14,806,0.45533498759305200,0.45533498759305200
2019-04-25,2019,4,287,406,6,699,0.4105865522174540,0.4105865522174540
2019-04-26,2019,4,192,342,10,544,0.35294117647058800,0.35294117647058800
2019-04-27,2019,4,144,364,7,515,0.2796116504854370,0.2796116504854370
2019-04-28,2019,4,150,322,6,478,0.3138075313807530,0.3138075313807530
2019-04-29,2019,4,172,328,3,503,0.341948310139165,0.341948310139165
2019-04-30,2019,4,308,390,6,704,0.4375,0.4375
2019-05-01,2019,5,347,449,5,801,0.4332084893882650,0.4332084893882650
2019-05-02,2019,5,372,495,8,875,0.42514285714285700,0.42514285714285700
2019-05-03,2019,5,248,407,7,662,0.37462235649546800,0.37462235649546800
2019-05-04,2019,5,188,335,11,534,0.352059925093633,0.352059925093633
2019-05-05,2019,5,136,264,0,400,0.34,0.34
2019-05-06,2019,5,223,346,6,575,0.38782608695652200,0.38782608695652200
2019-05-07,2019,5,307,451,8,766,0.4007832898172320,0.4007832898172320
2019-05-08,2019,5,331,415,6,752,0.4401595744680850,0.4401595744680850
2019-05-09,2019,5,306,456,6,768,0.3984375,0.3984375
2019-05-10,2019,5,268,438,12,718,0.3732590529247910,0.3732590529247910
2019-05-11,2019,5,165,345,5,515,0.32038834951456300,0.32038834951456300
2019-05-12,2019,5,102,255,3,360,0.2833333333333330,0.2833333333333330
2019-05-13,2019,5,182,269,3,454,0.4008810572687230,0.4008810572687230
2019-05-14,2019,5,290,382,7,679,0.4270986745213550,0.4270986745213550
2019-05-15,2019,5,325,428,19,772,0.4209844559585490,0.4209844559585490
2019-05-16,2019,5,269,375,13,657,0.4094368340943680,0.4094368340943680
2019-05-17,2019,5,225,362,11,598,0.3762541806020070,0.3762541806020070
2019-05-18,2019,5,198,335,8,541,0.3659889094269870,0.3659889094269870
2019-05-19,2019,5,166,316,12,494,0.3360323886639680,0.3360323886639680
2019-05-20,2019,5,182,341,1,524,0.3473282442748090,0.3473282442748090
2019-05-21,2019,5,312,418,13,743,0.4199192462987890,0.4199192462987890
2019-05-22,2019,5,310,420,10,740,0.4189189189189190,0.4189189189189190
2019-05-23,2019,5,298,379,4,681,0.43759177679882500,0.43759177679882500
2019-05-24,2019,5,259,403,8,670,0.38656716417910400,0.38656716417910400
2019-05-25,2019,5,195,386,5,586,0.33276450511945400,0.33276450511945400
2019-05-26,2019,5,113,318,11,442,0.25565610859728500,0.25565610859728500
2019-05-27,2019,5,150,314,4,468,0.32051282051282100,0.32051282051282100
2019-05-28,2019,5,293,393,6,692,0.4234104046242780,0.4234104046242780
2019-05-29,2019,5,265,415,5,685,0.38686131386861300,0.38686131386861300
2019-05-30,2019,5,292,399,9,700,0.41714285714285700,0.41714285714285700
2019-05-31,2019,5,258,321,6,585,0.441025641025641,0.441025641025641
2019-06-01,2019,6,187,345,13,545,0.3431192660550460,0.3431192660550460
2019-06-02,2019,6,140,303,11,454,0.30837004405286300,0.30837004405286300
2019-06-03,2019,6,197,317,4,518,0.3803088803088800,0.3803088803088800
2019-06-04,2019,6,312,404,5,721,0.43273231622746200,0.43273231622746200
2019-06-05,2019,6,334,442,10,786,0.42493638676844800,0.42493638676844800
2019-06-06,2019,6,334,431,8,773,0.4320827943078910,0.4320827943078910
2019-06-07,2019,6,244,383,13,640,0.38125,0.38125
2019-06-08,2019,6,135,320,7,462,0.2922077922077920,0.2922077922077920
2019-06-09,2019,6,157,335,12,504,0.3115079365079370,0.3115079365079370
2019-06-10,2019,6,197,285,6,488,0.4036885245901640,0.4036885245901640
2019-06-11,2019,6,284,362,9,655,0.433587786259542,0.433587786259542
2019-06-12,2019,6,330,435,3,768,0.4296875,0.4296875
2019-06-13,2019,6,310,369,3,682,0.45454545454545500,0.45454545454545500
2019-06-14,2019,6,223,378,6,607,0.3673805601317960,0.3673805601317960
2019-06-15,2019,6,191,352,6,549,0.34790528233151200,0.34790528233151200
2019-06-16,2019,6,131,286,5,422,0.3104265402843600,0.3104265402843600
2019-06-17,2019,6,211,328,8,547,0.3857404021937840,0.3857404021937840
2019-06-18,2019,6,242,385,5,632,0.3829113924050630,0.3829113924050630
2019-06-19,2019,6,327,413,5,745,0.4389261744966440,0.4389261744966440
2019-06-20,2019,6,240,392,3,635,0.3779527559055120,0.3779527559055120
2019-06-21,2019,6,210,392,6,608,0.34539473684210500,0.34539473684210500
2019-06-22,2019,6,160,322,73,555,0.2882882882882880,0.2882882882882880
2019-06-23,2019,6,151,278,7,436,0.3463302752293580,0.3463302752293580
2019-06-24,2019,6,191,280,3,474,0.4029535864978900,0.4029535864978900
2019-06-25,2019,6,204,297,9,510,0.4,0.4
2019-06-26,2019,6,252,381,3,636,0.39622641509434000,0.39622641509434000
2019-06-27,2019,6,235,337,7,579,0.4058721934369600,0.4058721934369600
2019-06-28,2019,6,186,283,5,474,0.3924050632911390,0.3924050632911390
2019-06-29,2019,6,179,326,3,508,0.35236220472440900,0.35236220472440900
2019-06-30,2019,6,107,277,11,395,0.2708860759493670,0.2708860759493670
2019-07-01,2019,7,219,309,6,534,0.4101123595505620,0.4101123595505620
2019-07-02,2019,7,340,390,6,736,0.46195652173913000,0.46195652173913000
2019-07-03,2019,7,380,393,13,786,0.48346055979643800,0.48346055979643800
2019-07-04,2019,7,180,354,10,544,0.33088235294117600,0.33088235294117600
2019-07-05,2019,7,268,426,4,698,0.3839541547277940,0.3839541547277940
2019-07-06,2019,7,198,368,12,578,0.34256055363321800,0.34256055363321800
2019-07-07,2019,7,171,319,4,494,0.34615384615384600,0.34615384615384600
2019-07-08,2019,7,229,316,3,548,0.41788321167883200,0.41788321167883200
2019-07-09,2019,7,297,436,12,745,0.39865771812080500,0.39865771812080500
2019-07-10,2019,7,322,413,7,742,0.4339622641509430,0.4339622641509430
2019-07-11,2019,7,327,432,11,770,0.42467532467532500,0.42467532467532500
2019-07-12,2019,7,260,395,7,662,0.39274924471299100,0.39274924471299100
2019-07-13,2019,7,202,330,10,542,0.3726937269372690,0.3726937269372690
2019-07-14,2019,7,141,331,3,475,0.2968421052631580,0.2968421052631580
2019-07-15,2019,7,209,316,49,574,0.3641114982578400,0.3641114982578400
2019-07-16,2019,7,323,396,4,723,0.4467496542185340,0.4467496542185340
2019-07-17,2019,7,316,383,7,706,0.4475920679886690,0.4475920679886690
2019-07-18,2019,7,275,391,4,670,0.41044776119403000,0.41044776119403000
2019-07-19,2019,7,237,405,9,651,0.3640552995391710,0.3640552995391710
2019-07-20,2019,7,199,319,8,526,0.37832699619771900,0.37832699619771900
2019-07-21,2019,7,158,310,8,476,0.3319327731092440,0.3319327731092440
2019-07-22,2019,7,227,315,4,546,0.4157509157509160,0.4157509157509160
2019-07-23,2019,7,283,403,10,696,0.40660919540229900,0.40660919540229900
2019-07-24,2019,7,349,465,18,832,0.41947115384615400,0.41947115384615400
2019-07-25,2019,7,339,427,13,779,0.43517329910141200,0.43517329910141200
2019-07-26,2019,7,237,386,4,627,0.37799043062201000,0.37799043062201000
2019-07-27,2019,7,157,294,9,460,0.34130434782608700,0.34130434782608700
2019-07-28,2019,7,145,319,10,474,0.3059071729957810,0.3059071729957810
2019-07-29,2019,7,187,297,8,492,0.3800813008130080,0.3800813008130080
2019-07-30,2019,7,268,349,5,622,0.43086816720257200,0.43086816720257200
2019-07-31,2019,7,296,394,9,699,0.4234620886981400,0.4234620886981400
2019-08-01,2019,8,317,408,10,735,0.4312925170068030,0.4312925170068030
2019-08-02,2019,8,270,417,3,690,0.391304347826087,0.391304347826087
2019-08-03,2019,8,191,317,8,516,0.3701550387596900,0.3701550387596900
2019-08-04,2019,8,153,300,2,455,0.3362637362637360,0.3362637362637360
2019-08-05,2019,8,211,315,2,528,0.3996212121212120,0.3996212121212120
2019-08-06,2019,8,289,328,3,620,0.4661290322580650,0.4661290322580650
2019-08-07,2019,8,324,410,5,739,0.43843031123139400,0.43843031123139400
2019-08-08,2019,8,351,425,6,782,0.44884910485933500,0.44884910485933500
2019-08-09,2019,8,240,354,7,601,0.39933444259567400,0.39933444259567400
2019-08-10,2019,8,166,323,103,592,0.28040540540540500,0.28040540540540500
2019-08-11,2019,8,152,375,10,537,0.28305400372439500,0.28305400372439500
2019-08-12,2019,8,181,328,6,515,0.35145631067961200,0.35145631067961200
2019-08-13,2019,8,372,396,10,778,0.4781491002570690,0.4781491002570690
2019-08-14,2019,8,407,388,4,799,0.509386733416771,0.509386733416771
2019-08-15,2019,8,324,418,3,745,0.4348993288590600,0.4348993288590600
2019-08-16,2019,8,264,375,8,647,0.4080370942812980,0.4080370942812980
2019-08-17,2019,8,189,364,4,557,0.3393177737881510,0.3393177737881510
2019-08-18,2019,8,144,267,5,416,0.34615384615384600,0.34615384615384600
2019-08-19,2019,8,188,244,3,435,0.432183908045977,0.432183908045977
2019-08-20,2019,8,231,299,7,537,0.4301675977653630,0.4301675977653630
2019-08-21,2019,8,268,373,6,647,0.4142194744976820,0.4142194744976820
2019-08-22,2019,8,238,318,4,560,0.425,0.425
2019-08-23,2019,8,179,290,7,476,0.3760504201680670,0.3760504201680670
2019-08-24,2019,8,175,269,4,448,0.390625,0.390625
2019-08-25,2019,8,137,237,1,375,0.36533333333333300,0.36533333333333300
2019-08-26,2019,8,199,224,6,429,0.46386946386946400,0.46386946386946400
2019-08-27,2019,8,230,307,2,539,0.4267161410018550,0.4267161410018550
2019-08-28,2019,8,262,344,15,621,0.4219001610305960,0.4219001610305960
2019-08-29,2019,8,248,306,5,559,0.44364937388193200,0.44364937388193200
2019-08-30,2019,8,198,379,4,581,0.3407917383821000,0.3407917383821000
2019-08-31,2019,8,153,329,12,494,0.3097165991902830,0.3097165991902830
2019-09-01,2019,9,150,265,4,419,0.35799522673031000,0.35799522673031000
2019-09-02,2019,9,150,209,4,363,0.4132231404958680,0.4132231404958680
2019-09-03,2019,9,231,314,7,552,0.41847826086956500,0.41847826086956500
2019-09-04,2019,9,303,378,5,686,0.44169096209912500,0.44169096209912500
2019-09-05,2019,9,356,336,3,695,0.5122302158273380,0.5122302158273380
2019-09-06,2019,9,255,324,5,584,0.4366438356164380,0.4366438356164380
2019-09-07,2019,9,174,317,5,496,0.35080645161290300,0.35080645161290300
2019-09-08,2019,9,165,310,3,478,0.34518828451882800,0.34518828451882800
2019-09-09,2019,9,196,259,3,458,0.4279475982532750,0.4279475982532750
2019-09-10,2019,9,321,307,3,631,0.508716323296355,0.508716323296355
2019-09-11,2019,9,329,383,3,715,0.46013986013986000,0.46013986013986000
2019-09-12,2019,9,298,349,3,650,0.4584615384615390,0.4584615384615390
2019-09-13,2019,9,234,360,7,601,0.389351081530782,0.389351081530782
2019-09-14,2019,9,165,323,86,574,0.2874564459930310,0.2874564459930310
2019-09-15,2019,9,155,285,1,441,0.35147392290249400,0.35147392290249400
2019-09-16,2019,9,214,270,2,486,0.4403292181069960,0.4403292181069960
2019-09-17,2019,9,295,374,2,671,0.4396423248882270,0.4396423248882270
2019-09-18,2019,9,301,425,6,732,0.41120218579235000,0.41120218579235000
2019-09-19,2019,9,320,397,2,719,0.44506258692628700,0.44506258692628700
2019-09-20,2019,9,249,336,4,589,0.4227504244482170,0.4227504244482170
2019-09-21,2019,9,153,334,4,491,0.31160896130346200,0.31160896130346200
2019-09-22,2019,9,122,291,8,421,0.28978622327791000,0.28978622327791000
2019-09-23,2019,9,180,292,0,472,0.3813559322033900,0.3813559322033900
2019-09-24,2019,9,266,350,6,622,0.42765273311897100,0.42765273311897100
2019-09-25,2019,9,224,359,39,622,0.36012861736334400,0.36012861736334400
2019-09-26,2019,9,257,306,6,569,0.45166959578207400,0.45166959578207400
2019-09-27,2019,9,188,346,5,539,0.34879406307977700,0.34879406307977700
2019-09-28,2019,9,146,266,5,417,0.3501199040767390,0.3501199040767390
2019-09-29,2019,9,104,248,3,355,0.29295774647887300,0.29295774647887300
2019-09-30,2019,9,175,289,4,468,0.37393162393162400,0.37393162393162400
2019-10-01,2019,10,300,363,2,665,0.45112781954887200,0.45112781954887200
2019-10-02,2019,10,332,407,11,750,0.44266666666666700,0.44266666666666700
2019-10-03,2019,10,295,291,10,596,0.4949664429530200,0.4949664429530200
2019-10-04,2019,10,137,248,5,390,0.35128205128205100,0.35128205128205100
2019-10-05,2019,10,137,266,3,406,0.3374384236453200,0.3374384236453200
2019-10-06,2019,10,137,248,2,387,0.35400516795865600,0.35400516795865600
2019-10-07,2019,10,205,295,67,567,0.36155202821869500,0.36155202821869500
2019-10-08,2019,10,305,426,2,733,0.41609822646657600,0.41609822646657600
2019-10-09,2019,10,324,361,5,690,0.46956521739130400,0.46956521739130400
2019-10-10,2019,10,302,414,58,774,0.39018087855297200,0.39018087855297200
2019-10-11,2019,10,265,350,2,617,0.42949756888168600,0.42949756888168600
2019-10-12,2019,10,159,306,8,473,0.3361522198731500,0.3361522198731500
2019-10-13,2019,10,151,254,2,407,0.371007371007371,0.371007371007371
2019-10-14,2019,10,165,268,0,433,0.3810623556581990,0.3810623556581990
2019-10-15,2019,10,266,339,5,610,0.4360655737704920,0.4360655737704920
2019-10-16,2019,10,260,354,3,617,0.4213938411669370,0.4213938411669370
2019-10-17,2019,10,306,385,3,694,0.4409221902017290,0.4409221902017290
2019-10-18,2019,10,241,297,4,542,0.4446494464944650,0.4446494464944650
2019-10-19,2019,10,162,292,6,460,0.3521739130434780,0.3521739130434780
2019-10-20,2019,10,121,245,1,367,0.329700272479564,0.329700272479564
2019-10-21,2019,10,213,294,3,510,0.4176470588235290,0.4176470588235290
2019-10-22,2019,10,285,338,7,630,0.4523809523809520,0.4523809523809520
2019-10-23,2019,10,299,402,6,707,0.4229137199434230,0.4229137199434230
2019-10-24,2019,10,320,390,4,714,0.4481792717086840,0.4481792717086840
2019-10-25,2019,10,246,345,11,602,0.40863787375415300,0.40863787375415300
2019-10-26,2019,10,144,300,4,448,0.32142857142857100,0.32142857142857100
2019-10-27,2019,10,108,235,4,347,0.3112391930835740,0.3112391930835740
2019-10-28,2019,10,211,250,2,463,0.4557235421166310,0.4557235421166310
2019-10-29,2019,10,268,290,5,563,0.47602131438721100,0.47602131438721100
2019-10-30,2019,10,274,377,9,660,0.41515151515151500,0.41515151515151500
2019-10-31,2019,10,196,263,6,465,0.421505376344086,0.421505376344086
2019-11-01,2019,11,240,308,9,557,0.43087971274685800,0.43087971274685800
2019-11-02,2019,11,148,244,2,394,0.3756345177664980,0.3756345177664980
2019-11-03,2019,11,150,263,2,415,0.3614457831325300,0.3614457831325300
2019-11-04,2019,11,175,259,0,434,0.4032258064516130,0.4032258064516130
2019-11-05,2019,11,222,300,6,528,0.42045454545454500,0.42045454545454500
2019-11-06,2019,11,282,448,2,732,0.38524590163934400,0.38524590163934400
2019-11-07,2019,11,277,385,7,669,0.414050822122571,0.414050822122571
2019-11-08,2019,11,254,303,2,559,0.4543828264758500,0.4543828264758500
2019-11-09,2019,11,165,258,2,425,0.38823529411764700,0.38823529411764700
2019-11-10,2019,11,157,227,3,387,0.40568475452196400,0.40568475452196400
2019-11-11,2019,11,187,260,3,450,0.41555555555555600,0.41555555555555600
2019-11-12,2019,11,213,281,2,496,0.42943548387096800,0.42943548387096800
2019-11-13,2019,11,284,364,3,651,0.4362519201228880,0.4362519201228880
2019-11-14,2019,11,338,363,4,705,0.4794326241134750,0.4794326241134750
2019-11-15,2019,11,231,321,9,561,0.4117647058823530,0.4117647058823530
2019-11-16,2019,11,139,294,2,435,0.3195402298850580,0.3195402298850580
2019-11-17,2019,11,112,220,5,337,0.3323442136498520,0.3323442136498520
2019-11-18,2019,11,211,256,2,469,0.44989339019189800,0.44989339019189800
2019-11-19,2019,11,333,348,4,685,0.48613138686131400,0.48613138686131400
2019-11-20,2019,11,315,360,4,679,0.4639175257731960,0.4639175257731960
2019-11-21,2019,11,349,375,4,728,0.4793956043956040,0.4793956043956040
2019-11-22,2019,11,253,315,5,573,0.44153577661431100,0.44153577661431100
2019-11-23,2019,11,164,297,4,465,0.35268817204301100,0.35268817204301100
2019-11-24,2019,11,110,244,1,355,0.30985915492957700,0.30985915492957700
2019-11-25,2019,11,229,299,0,528,0.4337121212121210,0.4337121212121210
2019-11-26,2019,11,256,355,5,616,0.4155844155844160,0.4155844155844160
2019-11-27,2019,11,219,305,3,527,0.4155597722960150,0.4155597722960150
2019-11-28,2019,11,105,135,0,240,0.4375,0.4375
2019-11-29,2019,11,157,253,2,412,0.38106796116504900,0.38106796116504900
2019-11-30,2019,11,133,248,8,389,0.34190231362467900,0.34190231362467900
2019-12-01,2019,12,116,211,5,332,0.3493975903614460,0.3493975903614460
2019-12-02,2019,12,146,197,3,346,0.42196531791907500,0.42196531791907500
2019-12-03,2019,12,266,332,8,606,0.4389438943894390,0.4389438943894390
2019-12-04,2019,12,339,354,6,699,0.48497854077253200,0.48497854077253200
2019-12-05,2019,12,291,392,3,686,0.42419825072886300,0.42419825072886300
2019-12-06,2019,12,236,333,5,574,0.41114982578397200,0.41114982578397200
2019-12-07,2019,12,146,254,4,404,0.3613861386138610,0.3613861386138610
2019-12-08,2019,12,138,240,6,384,0.359375,0.359375
2019-12-09,2019,12,156,213,1,370,0.42162162162162200,0.42162162162162200
2019-12-10,2019,12,275,337,3,615,0.44715447154471500,0.44715447154471500
2019-12-11,2019,12,255,334,8,597,0.4271356783919600,0.4271356783919600
2019-12-12,2019,12,240,341,5,586,0.40955631399317400,0.40955631399317400
2019-12-13,2019,12,185,295,5,485,0.38144329896907200,0.38144329896907200
2019-12-14,2019,12,166,238,7,411,0.40389294403892900,0.40389294403892900
2019-12-15,2019,12,124,261,5,390,0.31794871794871800,0.31794871794871800
2019-12-16,2019,12,214,236,2,452,0.47345132743362800,0.47345132743362800
2019-12-17,2019,12,242,239,1,482,0.5020746887966810,0.5020746887966810
2019-12-18,2019,12,234,277,6,517,0.4526112185686650,0.4526112185686650
2019-12-19,2019,12,231,237,4,472,0.4894067796610170,0.4894067796610170
2019-12-20,2019,12,164,256,3,423,0.3877068557919620,0.3877068557919620
2019-12-21,2019,12,127,271,1,399,0.3182957393483710,0.3182957393483710
2019-12-22,2019,12,114,218,1,333,0.34234234234234200,0.34234234234234200
2019-12-23,2019,12,162,245,4,411,0.39416058394160600,0.39416058394160600
2019-12-24,2019,12,92,138,3,233,0.3948497854077250,0.3948497854077250
2019-12-25,2019,12,72,103,3,178,0.4044943820224720,0.4044943820224720
2019-12-26,2019,12,178,257,1,436,0.40825688073394500,0.40825688073394500
2019-12-27,2019,12,176,265,2,443,0.3972911963882620,0.3972911963882620
2019-12-28,2019,12,115,227,1,343,0.33527696793002900,0.33527696793002900
2019-12-29,2019,12,98,190,2,290,0.33793103448275900,0.33793103448275900
2019-12-30,2019,12,130,193,3,326,0.3987730061349690,0.3987730061349690
2019-12-31,2019,12,111,147,1,259,0.42857142857142900,0.42857142857142900
2020-01-01,2020,1,196,292,3,491,0.39918533604888000,0.39918533604888000
2020-01-02,2020,1,265,369,2,636,0.4166666666666670,0.4166666666666670
2020-01-03,2020,1,212,251,6,469,0.4520255863539450,0.4520255863539450
2020-01-04,2020,1,161,204,9,374,0.4304812834224600,0.4304812834224600
2020-01-05,2020,1,137,210,6,353,0.3881019830028330,0.3881019830028330
2020-01-06,2020,1,210,243,4,457,0.45951859956236300,0.45951859956236300
2020-01-07,2020,1,252,301,3,556,0.45323741007194200,0.45323741007194200
2020-01-08,2020,1,291,303,4,598,0.4866220735785950,0.4866220735785950
2020-01-09,2020,1,253,336,9,598,0.4230769230769230,0.4230769230769230
2020-01-10,2020,1,251,313,5,569,0.44112478031634400,0.44112478031634400
2020-01-11,2020,1,168,262,5,435,0.38620689655172400,0.38620689655172400
2020-01-12,2020,1,107,241,3,351,0.30484330484330500,0.30484330484330500
2020-01-13,2020,1,221,287,5,513,0.43079922027290400,0.43079922027290400
2020-01-14,2020,1,307,334,6,647,0.47449768160741900,0.47449768160741900
2020-01-15,2020,1,325,361,7,693,0.468975468975469,0.468975468975469
2020-01-16,2020,1,270,334,6,610,0.4426229508196720,0.4426229508196720
2020-01-17,2020,1,232,274,8,514,0.45136186770428000,0.45136186770428000
2020-01-18,2020,1,113,222,3,338,0.3343195266272190,0.3343195266272190
2020-01-19,2020,1,104,238,1,343,0.3032069970845480,0.3032069970845480
2020-01-20,2020,1,182,262,7,451,0.4035476718403550,0.4035476718403550
2020-01-21,2020,1,305,291,6,602,0.5066445182724250,0.5066445182724250
2020-01-22,2020,1,285,372,7,664,0.4292168674698800,0.4292168674698800
2020-01-23,2020,1,282,339,4,625,0.4512,0.4512
2020-01-24,2020,1,217,299,4,520,0.4173076923076920,0.4173076923076920
2020-01-25,2020,1,129,253,7,389,0.33161953727506400,0.33161953727506400
2020-01-26,2020,1,110,250,11,371,0.29649595687331500,0.29649595687331500
2020-01-27,2020,1,207,233,3,443,0.4672686230248310,0.4672686230248310
2020-01-28,2020,1,240,354,3,597,0.4020100502512560,0.4020100502512560
2020-01-29,2020,1,316,326,2,644,0.4906832298136650,0.4906832298136650
2020-01-30,2020,1,313,347,6,666,0.46996996996997,0.46996996996997
2020-01-31,2020,1,216,289,2,507,0.4260355029585800,0.4260355029585800
2020-02-01,2020,2,171,282,3,456,0.375,0.375
2020-02-02,2020,2,117,231,1,349,0.335243553008596,0.335243553008596
2020-02-03,2020,2,188,281,1,470,0.4,0.4
2020-02-04,2020,2,280,356,1,637,0.43956043956044000,0.43956043956044000
2020-02-05,2020,2,342,401,1,744,0.4596774193548390,0.4596774193548390
2020-02-06,2020,2,294,334,2,630,0.4666666666666670,0.4666666666666670
2020-02-07,2020,2,213,320,5,538,0.395910780669145,0.395910780669145
2020-02-08,2020,2,137,290,5,432,0.31712962962963000,0.31712962962963000
2020-02-09,2020,2,140,269,2,411,0.340632603406326,0.340632603406326
2020-02-10,2020,2,179,254,3,436,0.4105504587155960,0.4105504587155960
2020-02-11,2020,2,290,285,2,577,0.5025996533795490,0.5025996533795490
2020-02-12,2020,2,315,363,7,685,0.45985401459854000,0.45985401459854000
2020-02-13,2020,2,274,325,1,600,0.45666666666666700,0.45666666666666700
2020-02-14,2020,2,206,305,2,513,0.4015594541910330,0.4015594541910330
2020-02-15,2020,2,164,263,3,430,0.3813953488372090,0.3813953488372090
2020-02-16,2020,2,131,231,4,366,0.35792349726776000,0.35792349726776000
2020-02-17,2020,2,225,299,2,526,0.42775665399239500,0.42775665399239500
2020-02-18,2020,2,279,378,1,658,0.42401215805471100,0.42401215805471100
2020-02-19,2020,2,246,353,6,605,0.4066115702479340,0.4066115702479340
2020-02-20,2020,2,242,348,5,595,0.40672268907563000,0.40672268907563000
2020-02-21,2020,2,230,302,7,539,0.4267161410018550,0.4267161410018550
2020-02-22,2020,2,155,263,3,421,0.3681710213776720,0.3681710213776720
2020-02-23,2020,2,134,272,3,409,0.3276283618581910,0.3276283618581910
2020-02-24,2020,2,188,305,1,494,0.3805668016194330,0.3805668016194330
2020-02-25,2020,2,236,298,4,538,0.43866171003717500,0.43866171003717500
2020-02-26,2020,2,290,427,7,724,0.4005524861878450,0.4005524861878450
2020-02-27,2020,2,257,289,4,550,0.4672727272727270,0.4672727272727270
2020-02-28,2020,2,231,295,4,530,0.4358490566037740,0.4358490566037740
2020-02-29,2020,2,160,248,7,415,0.3855421686746990,0.3855421686746990
2020-03-01,2020,3,171,233,2,406,0.4211822660098520,0.4211822660098520
2020-03-02,2020,3,231,297,1,529,0.43667296786389400,0.43667296786389400
2020-03-03,2020,3,275,337,4,616,0.44642857142857100,0.44642857142857100
2020-03-04,2020,3,346,416,4,766,0.4516971279373370,0.4516971279373370
2020-03-05,2020,3,339,358,2,699,0.48497854077253200,0.48497854077253200
2020-03-06,2020,3,257,283,3,543,0.4732965009208100,0.4732965009208100
2020-03-07,2020,3,182,310,5,497,0.36619718309859200,0.36619718309859200
2020-03-08,2020,3,157,238,5,400,0.3925,0.3925
2020-03-09,2020,3,178,228,1,407,0.43734643734643700,0.43734643734643700
2020-03-10,2020,3,334,397,6,737,0.4531886024423340,0.4531886024423340
2020-03-11,2020,3,282,424,6,712,0.3960674157303370,0.3960674157303370
2020-03-12,2020,3,322,342,5,669,0.4813153961136020,0.4813153961136020
2020-03-13,2020,3,257,335,4,596,0.4312080536912750,0.4312080536912750
2020-03-14,2020,3,189,299,3,491,0.384928716904277,0.384928716904277
2020-03-15,2020,3,142,249,1,392,0.3622448979591840,0.3622448979591840
2020-03-16,2020,3,150,171,1,322,0.4658385093167700,0.4658385093167700
2020-03-17,2020,3,159,203,1,363,0.4380165289256200,0.4380165289256200
2020-03-18,2020,3,256,212,1,469,0.5458422174840090,0.5458422174840090
2020-03-19,2020,3,185,223,1,409,0.45232273838630800,0.45232273838630800
2020-03-20,2020,3,169,185,3,357,0.4733893557422970,0.4733893557422970
2020-03-21,2020,3,159,167,1,327,0.48623853211009200,0.48623853211009200
2020-03-22,2020,3,100,124,1,225,0.4444444444444440,0.4444444444444440
2020-03-23,2020,3,84,99,0,183,0.45901639344262300,0.45901639344262300
2020-03-24,2020,3,140,140,0,280,0.5,0.5
2020-03-25,2020,3,151,172,1,324,0.4660493827160490,0.4660493827160490
2020-03-26,2020,3,134,138,0,272,0.49264705882352900,0.49264705882352900
2020-03-27,2020,3,140,149,1,290,0.4827586206896550,0.4827586206896550
2020-03-28,2020,3,106,91,1,198,0.5353535353535350,0.5353535353535350
2020-03-29,2020,3,60,92,0,152,0.39473684210526300,0.39473684210526300
2020-03-30,2020,3,82,121,1,204,0.4019607843137260,0.4019607843137260
2020-03-31,2020,3,102,128,1,231,0.44155844155844200,0.44155844155844200
2020-04-01,2020,4,115,147,0,262,0.4389312977099240,0.4389312977099240
2020-04-02,2020,4,108,136,1,245,0.44081632653061200,0.44081632653061200
2020-04-03,2020,4,88,113,0,201,0.43781094527363200,0.43781094527363200
2020-04-04,2020,4,78,96,1,175,0.44571428571428600,0.44571428571428600
2020-04-05,2020,4,80,90,0,170,0.47058823529411800,0.47058823529411800
2020-04-06,2020,4,84,82,1,167,0.5029940119760480,0.5029940119760480
2020-04-07,2020,4,121,137,3,261,0.46360153256705000,0.46360153256705000
2020-04-08,2020,4,159,136,1,296,0.5371621621621620,0.5371621621621620
2020-04-09,2020,4,138,145,1,284,0.4859154929577470,0.4859154929577470
2020-04-10,2020,4,113,103,0,216,0.5231481481481480,0.5231481481481480
2020-04-11,2020,4,78,119,1,198,0.3939393939393940,0.3939393939393940
2020-04-12,2020,4,88,108,0,196,0.4489795918367350,0.4489795918367350
2020-04-13,2020,4,86,100,1,187,0.45989304812834200,0.45989304812834200
2020-04-14,2020,4,139,115,0,254,0.547244094488189,0.547244094488189
2020-04-15,2020,4,163,157,0,320,0.509375,0.509375
2020-04-16,2020,4,147,153,0,300,0.49,0.49
2020-04-17,2020,4,132,146,3,281,0.4697508896797150,0.4697508896797150
2020-04-18,2020,4,95,127,0,222,0.42792792792792800,0.42792792792792800
2020-04-19,2020,4,115,119,0,234,0.49145299145299100,0.49145299145299100
2020-04-20,2020,4,137,140,0,277,0.49458483754512600,0.49458483754512600
2020-04-21,2020,4,139,158,0,297,0.468013468013468,0.468013468013468
2020-04-22,2020,4,183,201,1,385,0.4753246753246750,0.4753246753246750
2020-04-23,2020,4,191,192,4,387,0.4935400516795870,0.4935400516795870
2020-04-24,2020,4,164,164,0,328,0.5,0.5
2020-04-25,2020,4,155,171,2,328,0.4725609756097560,0.4725609756097560
2020-04-26,2020,4,83,153,1,237,0.350210970464135,0.350210970464135
2020-04-27,2020,4,127,149,2,278,0.4568345323741010,0.4568345323741010
2020-04-28,2020,4,231,200,1,432,0.5347222222222220,0.5347222222222220
2020-04-29,2020,4,219,198,1,418,0.5239234449760770,0.5239234449760770
2020-04-30,2020,4,219,195,0,414,0.5289855072463770,0.5289855072463770
2020-05-01,2020,5,183,197,1,381,0.48031496062992100,0.48031496062992100
2020-05-02,2020,5,192,208,13,413,0.4648910411622280,0.4648910411622280
2020-05-03,2020,5,138,183,1,322,0.42857142857142900,0.42857142857142900
2020-05-04,2020,5,166,192,1,359,0.4623955431754880,0.4623955431754880
2020-05-05,2020,5,233,244,2,479,0.48643006263048000,0.48643006263048000
2020-05-06,2020,5,207,227,0,434,0.4769585253456220,0.4769585253456220
2020-05-07,2020,5,254,253,3,510,0.4980392156862750,0.4980392156862750
2020-05-08,2020,5,191,189,0,380,0.5026315789473680,0.5026315789473680
2020-05-09,2020,5,111,158,1,270,0.4111111111111110,0.4111111111111110
2020-05-10,2020,5,119,145,1,265,0.4490566037735850,0.4490566037735850
2020-05-11,2020,5,167,195,1,363,0.46005509641873300,0.46005509641873300
2020-05-12,2020,5,281,273,0,554,0.5072202166064980,0.5072202166064980
2020-05-13,2020,5,285,257,4,546,0.521978021978022,0.521978021978022
2020-05-14,2020,5,276,318,1,595,0.4638655462184870,0.4638655462184870
2020-05-15,2020,5,204,258,1,463,0.4406047516198700,0.4406047516198700
2020-05-16,2020,5,144,200,0,344,0.4186046511627910,0.4186046511627910
2020-05-17,2020,5,166,186,1,353,0.4702549575070820,0.4702549575070820
2020-05-18,2020,5,175,183,0,358,0.4888268156424580,0.4888268156424580
2020-05-19,2020,5,279,294,3,576,0.484375,0.484375
2020-05-20,2020,5,246,283,4,533,0.46153846153846200,0.46153846153846200
2020-05-21,2020,5,254,277,4,535,0.4747663551401870,0.4747663551401870
2020-05-22,2020,5,275,253,4,532,0.5169172932330830,0.5169172932330830
2020-05-23,2020,5,161,204,2,367,0.43869209809264300,0.43869209809264300
2020-05-24,2020,5,131,178,1,310,0.42258064516129000,0.42258064516129000
2020-05-25,2020,5,152,211,1,364,0.4175824175824180,0.4175824175824180
2020-05-26,2020,5,266,276,2,544,0.4889705882352940,0.4889705882352940
2020-05-27,2020,5,310,308,3,621,0.499194847020934,0.499194847020934
2020-05-28,2020,5,258,307,2,567,0.455026455026455,0.455026455026455
2020-05-29,2020,5,202,268,0,470,0.4297872340425530,0.4297872340425530
2020-05-30,2020,5,144,219,0,363,0.39669421487603300,0.39669421487603300
2020-05-31,2020,5,136,168,1,305,0.4459016393442620,0.4459016393442620
2020-06-01,2020,6,411,365,6,782,0.5255754475703330,0.5255754475703330
2020-06-02,2020,6,368,218,5,591,0.622673434856176,0.622673434856176
2020-06-03,2020,6,136,123,3,262,0.5190839694656490,0.5190839694656490
2020-06-04,2020,6,134,208,3,345,0.3884057971014490,0.3884057971014490
2020-06-05,2020,6,95,102,0,197,0.48223350253807100,0.48223350253807100
2020-06-06,2020,6,104,106,0,210,0.49523809523809500,0.49523809523809500
2020-06-07,2020,6,116,135,3,254,0.4566929133858270,0.4566929133858270
2020-06-08,2020,6,94,136,1,231,0.4069264069264070,0.4069264069264070
2020-06-09,2020,6,125,123,1,249,0.5020080321285140,0.5020080321285140
2020-06-10,2020,6,122,102,2,226,0.5398230088495580,0.5398230088495580
2020-06-11,2020,6,113,158,0,271,0.41697416974169700,0.41697416974169700
2020-06-12,2020,6,109,105,2,216,0.5046296296296300,0.5046296296296300
2020-06-13,2020,6,116,111,1,228,0.5087719298245610,0.5087719298245610
2020-06-14,2020,6,114,106,1,221,0.5158371040723980,0.5158371040723980
2020-06-15,2020,6,123,117,1,241,0.5103734439834030,0.5103734439834030
2020-06-16,2020,6,151,123,1,275,0.5490909090909090,0.5490909090909090
2020-06-17,2020,6,147,115,0,262,0.5610687022900760,0.5610687022900760
2020-06-18,2020,6,135,130,0,265,0.5094339622641510,0.5094339622641510
2020-06-19,2020,6,91,115,0,206,0.441747572815534,0.441747572815534
2020-06-20,2020,6,67,96,0,163,0.4110429447852760,0.4110429447852760
2020-06-21,2020,6,64,85,1,150,0.4266666666666670,0.4266666666666670
2020-06-22,2020,6,113,119,0,232,0.4870689655172410,0.4870689655172410
2020-06-23,2020,6,125,135,0,260,0.4807692307692310,0.4807692307692310
2020-06-24,2020,6,165,155,0,320,0.515625,0.515625
2020-06-25,2020,6,159,125,0,284,0.5598591549295780,0.5598591549295780
2020-06-26,2020,6,107,104,0,211,0.5071090047393370,0.5071090047393370
2020-06-27,2020,6,73,102,0,175,0.41714285714285700,0.41714285714285700
2020-06-28,2020,6,87,98,1,186,0.46774193548387100,0.46774193548387100
2020-06-29,2020,6,111,115,0,226,0.4911504424778760,0.4911504424778760
2020-06-30,2020,6,145,127,0,272,0.5330882352941180,0.5330882352941180
2020-07-01,2020,7,161,135,0,296,0.543918918918919,0.543918918918919
2020-07-02,2020,7,123,110,0,233,0.5278969957081550,0.5278969957081550
2020-07-03,2020,7,80,121,1,202,0.39603960396039600,0.39603960396039600
2020-07-04,2020,7,66,90,0,156,0.4230769230769230,0.4230769230769230
2020-07-05,2020,7,87,99,0,186,0.46774193548387100,0.46774193548387100
2020-07-06,2020,7,84,95,0,179,0.4692737430167600,0.4692737430167600
2020-07-07,2020,7,119,114,0,233,0.5107296137339060,0.5107296137339060
2020-07-08,2020,7,119,139,0,258,0.46124031007751900,0.46124031007751900
2020-07-09,2020,7,125,123,0,248,0.5040322580645160,0.5040322580645160
2020-07-10,2020,7,95,102,0,197,0.48223350253807100,0.48223350253807100
2020-07-11,2020,7,82,77,0,159,0.5157232704402520,0.5157232704402520
2020-07-12,2020,7,76,109,0,185,0.41081081081081100,0.41081081081081100
2020-07-13,2020,7,102,85,0,187,0.5454545454545450,0.5454545454545450
2020-07-14,2020,7,167,161,0,328,0.5091463414634150,0.5091463414634150
2020-07-15,2020,7,155,129,0,284,0.545774647887324,0.545774647887324
2020-07-16,2020,7,143,110,0,253,0.5652173913043480,0.5652173913043480
2020-07-17,2020,7,110,137,0,247,0.44534412955465600,0.44534412955465600
2020-07-18,2020,7,78,88,1,167,0.46706586826347300,0.46706586826347300
2020-07-19,2020,7,65,97,0,162,0.4012345679012350,0.4012345679012350
2020-07-20,2020,7,125,99,0,224,0.5580357142857140,0.5580357142857140
2020-07-21,2020,7,190,129,1,320,0.59375,0.59375
2020-07-22,2020,7,200,142,1,343,0.5830903790087460,0.5830903790087460
2020-07-23,2020,7,174,130,0,304,0.5723684210526320,0.5723684210526320
2020-07-24,2020,7,124,158,1,283,0.4381625441696110,0.4381625441696110
2020-07-25,2020,7,75,104,1,180,0.4166666666666670,0.4166666666666670
2020-07-26,2020,7,80,99,0,179,0.44692737430167600,0.44692737430167600
2020-07-27,2020,7,107,102,0,209,0.5119617224880380,0.5119617224880380
2020-07-28,2020,7,172,199,0,371,0.4636118598382750,0.4636118598382750
2020-07-29,2020,7,170,144,0,314,0.5414012738853500,0.5414012738853500
2020-07-30,2020,7,129,121,0,250,0.516,0.516
2020-07-31,2020,7,110,99,0,209,0.5263157894736840,0.5263157894736840
2020-08-01,2020,8,108,145,1,254,0.4251968503937010,0.4251968503937010
2020-08-02,2020,8,119,116,0,235,0.5063829787234040,0.5063829787234040
2020-08-03,2020,8,135,152,0,287,0.47038327526132400,0.47038327526132400
2020-08-04,2020,8,141,134,0,275,0.5127272727272730,0.5127272727272730
2020-08-05,2020,8,216,200,1,417,0.5179856115107910,0.5179856115107910
2020-08-06,2020,8,212,176,0,388,0.5463917525773200,0.5463917525773200
2020-08-07,2020,8,174,170,1,345,0.5043478260869570,0.5043478260869570
2020-08-08,2020,8,118,128,0,246,0.4796747967479680,0.4796747967479680
2020-08-09,2020,8,92,118,1,211,0.43601895734597200,0.43601895734597200
2020-08-10,2020,8,151,150,0,301,0.5016611295681060,0.5016611295681060
2020-08-11,2020,8,212,163,0,375,0.5653333333333330,0.5653333333333330
2020-08-12,2020,8,228,186,0,414,0.5507246376811590,0.5507246376811590
2020-08-13,2020,8,203,204,1,408,0.49754901960784300,0.49754901960784300
2020-08-14,2020,8,184,146,0,330,0.5575757575757580,0.5575757575757580
2020-08-15,2020,8,97,139,0,236,0.4110169491525420,0.4110169491525420
2020-08-16,2020,8,96,109,1,206,0.46601941747572800,0.46601941747572800
2020-08-17,2020,8,162,140,0,302,0.5364238410596030,0.5364238410596030
2020-08-18,2020,8,216,186,0,402,0.5373134328358210,0.5373134328358210
2020-08-19,2020,8,211,205,1,417,0.5059952038369300,0.5059952038369300
2020-08-20,2020,8,200,162,1,363,0.5509641873278240,0.5509641873278240
2020-08-21,2020,8,186,164,2,352,0.5284090909090910,0.5284090909090910
2020-08-22,2020,8,122,133,0,255,0.47843137254902000,0.47843137254902000
2020-08-23,2020,8,105,115,1,221,0.4751131221719460,0.4751131221719460
2020-08-24,2020,8,146,123,1,270,0.5407407407407410,0.5407407407407410
2020-08-25,2020,8,192,156,0,348,0.5517241379310350,0.5517241379310350
2020-08-26,2020,8,213,203,3,419,0.5083532219570410,0.5083532219570410
2020-08-27,2020,8,197,145,1,343,0.5743440233236150,0.5743440233236150
2020-08-28,2020,8,149,144,0,293,0.5085324232081910,0.5085324232081910
2020-08-29,2020,8,130,137,1,268,0.48507462686567200,0.48507462686567200
2020-08-30,2020,8,112,125,0,237,0.47257383966244700,0.47257383966244700
2020-08-31,2020,8,144,126,0,270,0.5333333333333330,0.5333333333333330
2020-09-01,2020,9,257,204,0,461,0.5574837310195230,0.5574837310195230
2020-09-02,2020,9,255,229,0,484,0.5268595041322310,0.5268595041322310
2020-09-03,2020,9,252,209,0,461,0.5466377440347070,0.5466377440347070
2020-09-04,2020,9,204,163,0,367,0.555858310626703,0.555858310626703
2020-09-05,2020,9,167,186,0,353,0.4730878186968840,0.4730878186968840
2020-09-06,2020,9,141,140,0,281,0.501779359430605,0.501779359430605
2020-09-07,2020,9,146,138,3,287,0.5087108013937280,0.5087108013937280
2020-09-08,2020,9,213,207,1,421,0.505938242280285,0.505938242280285
2020-09-09,2020,9,257,200,0,457,0.562363238512035,0.562363238512035
2020-09-10,2020,9,204,217,1,422,0.4834123222748820,0.4834123222748820
2020-09-11,2020,9,182,194,0,376,0.48404255319148900,0.48404255319148900
2020-09-12,2020,9,142,185,1,328,0.4329268292682930,0.4329268292682930
2020-09-13,2020,9,133,153,0,286,0.46503496503496500,0.46503496503496500
2020-09-14,2020,9,174,150,0,324,0.5370370370370370,0.5370370370370370
2020-09-15,2020,9,238,192,1,431,0.5522041763341070,0.5522041763341070
2020-09-16,2020,9,235,203,1,439,0.5353075170842830,0.5353075170842830
2020-09-17,2020,9,235,220,0,455,0.5164835164835170,0.5164835164835170
2020-09-18,2020,9,178,179,0,357,0.49859943977591000,0.49859943977591000
2020-09-19,2020,9,114,162,1,277,0.41155234657039700,0.41155234657039700
2020-09-20,2020,9,113,126,0,239,0.47280334728033500,0.47280334728033500
2020-09-21,2020,9,183,136,0,319,0.5736677115987460,0.5736677115987460
2020-09-22,2020,9,186,184,1,371,0.5013477088948790,0.5013477088948790
2020-09-23,2020,9,217,222,2,441,0.49206349206349200,0.49206349206349200
2020-09-24,2020,9,190,213,3,406,0.46798029556650200,0.46798029556650200
2020-09-25,2020,9,171,155,1,327,0.5229357798165140,0.5229357798165140
2020-09-26,2020,9,197,201,0,398,0.4949748743718590,0.4949748743718590
2020-09-27,2020,9,147,158,1,306,0.4803921568627450,0.4803921568627450
2020-09-28,2020,9,145,160,1,306,0.4738562091503270,0.4738562091503270
2020-09-29,2020,9,160,179,2,341,0.46920821114369500,0.46920821114369500
2020-09-30,2020,9,223,199,0,422,0.5284360189573460,0.5284360189573460
2020-10-01,2020,10,330,267,0,597,0.5527638190954770,0.5527638190954770
2020-10-02,2020,10,228,231,1,460,0.4956521739130440,0.4956521739130440
2020-10-03,2020,10,146,164,1,311,0.4694533762057880,0.4694533762057880
2020-10-04,2020,10,119,163,0,282,0.4219858156028370,0.4219858156028370
2020-10-05,2020,10,180,181,0,361,0.4986149584487540,0.4986149584487540
2020-10-06,2020,10,231,239,0,470,0.49148936170212800,0.49148936170212800
2020-10-07,2020,10,261,244,0,505,0.5168316831683170,0.5168316831683170
2020-10-08,2020,10,327,274,4,605,0.540495867768595,0.540495867768595
2020-10-09,2020,10,155,208,1,364,0.4258241758241760,0.4258241758241760
2020-10-10,2020,10,165,212,0,377,0.4376657824933690,0.4376657824933690
2020-10-11,2020,10,159,176,1,336,0.4732142857142860,0.4732142857142860
2020-10-12,2020,10,144,155,0,299,0.4816053511705690,0.4816053511705690
2020-10-13,2020,10,250,223,1,474,0.5274261603375530,0.5274261603375530
2020-10-14,2020,10,290,264,0,554,0.5234657039711190,0.5234657039711190
2020-10-15,2020,10,306,248,0,554,0.5523465703971120,0.5523465703971120
2020-10-16,2020,10,160,210,1,371,0.431266846361186,0.431266846361186
2020-10-17,2020,10,147,199,0,346,0.42485549132948000,0.42485549132948000
2020-10-18,2020,10,112,161,1,274,0.40875912408759100,0.40875912408759100
2020-10-19,2020,10,221,177,1,399,0.5538847117794490,0.5538847117794490
2020-10-20,2020,10,256,259,0,515,0.4970873786407770,0.4970873786407770
2020-10-21,2020,10,274,237,0,511,0.5362035225048920,0.5362035225048920
2020-10-22,2020,10,239,286,1,526,0.4543726235741450,0.4543726235741450
2020-10-23,2020,10,195,220,0,415,0.46987951807228900,0.46987951807228900
2020-10-24,2020,10,156,163,0,319,0.4890282131661440,0.4890282131661440
2020-10-25,2020,10,127,148,0,275,0.4618181818181820,0.4618181818181820
2020-10-26,2020,10,118,171,0,289,0.4083044982698960,0.4083044982698960
2020-10-27,2020,10,268,236,6,510,0.5254901960784310,0.5254901960784310
2020-10-28,2020,10,326,231,1,558,0.5842293906810040,0.5842293906810040
2020-10-29,2020,10,221,158,0,379,0.58311345646438,0.58311345646438
2020-10-30,2020,10,135,161,1,297,0.45454545454545500,0.45454545454545500
2020-10-31,2020,10,132,177,0,309,0.42718446601941700,0.42718446601941700
2020-11-01,2020,11,147,178,2,327,0.44954128440367000,0.44954128440367000
2020-11-02,2020,11,167,176,0,343,0.4868804664723030,0.4868804664723030
2020-11-03,2020,11,110,138,1,249,0.44176706827309200,0.44176706827309200
2020-11-04,2020,11,205,200,2,407,0.5036855036855040,0.5036855036855040
2020-11-05,2020,11,179,235,0,414,0.4323671497584540,0.4323671497584540
2020-11-06,2020,11,156,219,0,375,0.416,0.416
2020-11-07,2020,11,168,192,0,360,0.4666666666666670,0.4666666666666670
2020-11-08,2020,11,146,168,2,316,0.4620253164556960,0.4620253164556960
2020-11-09,2020,11,122,165,0,287,0.4250871080139370,0.4250871080139370
2020-11-10,2020,11,207,263,3,473,0.4376321353065540,0.4376321353065540
2020-11-11,2020,11,206,221,0,427,0.48243559718969600,0.48243559718969600
2020-11-12,2020,11,240,277,0,517,0.46421663442940000,0.46421663442940000
2020-11-13,2020,11,168,209,1,378,0.4444444444444440,0.4444444444444440
2020-11-14,2020,11,153,204,0,357,0.42857142857142900,0.42857142857142900
2020-11-15,2020,11,133,162,1,296,0.44932432432432400,0.44932432432432400
2020-11-16,2020,11,184,185,0,369,0.4986449864498650,0.4986449864498650
2020-11-17,2020,11,232,265,0,497,0.46680080482897400,0.46680080482897400
2020-11-18,2020,11,247,269,1,517,0.47775628626692500,0.47775628626692500
2020-11-19,2020,11,233,232,0,465,0.5010752688172040,0.5010752688172040
2020-11-20,2020,11,183,268,3,454,0.40308370044052900,0.40308370044052900
2020-11-21,2020,11,182,189,3,374,0.48663101604278100,0.48663101604278100
2020-11-22,2020,11,152,197,2,351,0.43304843304843300,0.43304843304843300
2020-11-23,2020,11,186,192,0,378,0.49206349206349200,0.49206349206349200
2020-11-24,2020,11,249,249,0,498,0.5,0.5
2020-11-25,2020,11,190,220,0,410,0.4634146341463420,0.4634146341463420
2020-11-26,2020,11,83,94,0,177,0.4689265536723160,0.4689265536723160
2020-11-27,2020,11,146,197,0,343,0.42565597667638500,0.42565597667638500
2020-11-28,2020,11,183,197,1,381,0.48031496062992100,0.48031496062992100
2020-11-29,2020,11,146,155,0,301,0.4850498338870430,0.4850498338870430
2020-11-30,2020,11,136,158,2,296,0.4594594594594600,0.4594594594594600
2020-12-01,2020,12,272,271,0,543,0.5009208103130760,0.5009208103130760
2020-12-02,2020,12,296,257,1,554,0.5342960288808670,0.5342960288808670
2020-12-03,2020,12,303,290,0,593,0.5109612141652610,0.5109612141652610
2020-12-04,2020,12,226,244,2,472,0.4788135593220340,0.4788135593220340
2020-12-05,2020,12,157,199,0,356,0.4410112359550560,0.4410112359550560
2020-12-06,2020,12,135,182,0,317,0.42586750788643500,0.42586750788643500
2020-12-07,2020,12,191,200,0,391,0.4884910485933500,0.4884910485933500
2020-12-08,2020,12,247,246,2,495,0.498989898989899,0.498989898989899
2020-12-09,2020,12,254,272,1,527,0.4819734345351040,0.4819734345351040
2020-12-10,2020,12,296,275,0,571,0.5183887915936950,0.5183887915936950
2020-12-11,2020,12,221,258,1,480,0.46041666666666700,0.46041666666666700
2020-12-12,2020,12,213,237,1,451,0.4722838137472280,0.4722838137472280
2020-12-13,2020,12,156,189,0,345,0.45217391304347800,0.45217391304347800
2020-12-14,2020,12,172,164,0,336,0.5119047619047620,0.5119047619047620
2020-12-15,2020,12,279,247,1,527,0.5294117647058820,0.5294117647058820
2020-12-16,2020,12,175,160,0,335,0.5223880597014930,0.5223880597014930
2020-12-17,2020,12,101,131,0,232,0.4353448275862070,0.4353448275862070
2020-12-18,2020,12,175,182,2,359,0.48746518105849600,0.48746518105849600
2020-12-19,2020,12,149,215,1,365,0.40821917808219200,0.40821917808219200
2020-12-20,2020,12,133,198,1,332,0.4006024096385540,0.4006024096385540
2020-12-21,2020,12,157,198,1,356,0.4410112359550560,0.4410112359550560
2020-12-22,2020,12,209,227,1,437,0.4782608695652170,0.4782608695652170
2020-12-23,2020,12,200,210,1,411,0.48661800486618000,0.48661800486618000
2020-12-24,2020,12,80,115,0,195,0.41025641025641000,0.41025641025641000
2020-12-25,2020,12,84,95,0,179,0.4692737430167600,0.4692737430167600
2020-12-26,2020,12,142,171,1,314,0.45222929936305700,0.45222929936305700
2020-12-27,2020,12,148,162,0,310,0.4774193548387100,0.4774193548387100
2020-12-28,2020,12,198,177,2,377,0.5251989389920420,0.5251989389920420
2020-12-29,2020,12,227,177,3,407,0.5577395577395580,0.5577395577395580
2020-12-30,2020,12,220,251,3,474,0.4641350210970460,0.4641350210970460
2020-12-31,2020,12,191,148,1,340,0.5617647058823530,0.5617647058823530
2021-01-01,2021,1,196,240,2,438,0.4474885844748860,0.4474885844748860
2021-01-02,2021,1,179,205,2,386,0.4637305699481870,0.4637305699481870
2021-01-03,2021,1,133,174,0,307,0.43322475570032600,0.43322475570032600
2021-01-04,2021,1,178,178,1,357,0.49859943977591000,0.49859943977591000
2021-01-05,2021,1,301,289,0,590,0.5101694915254240,0.5101694915254240
2021-01-06,2021,1,334,291,1,626,0.5335463258785940,0.5335463258785940
2021-01-07,2021,1,279,245,1,525,0.5314285714285720,0.5314285714285720
2021-01-08,2021,1,227,267,0,494,0.45951417004048600,0.45951417004048600
2021-01-09,2021,1,144,205,0,349,0.41260744985673400,0.41260744985673400
2021-01-10,2021,1,129,158,0,287,0.44947735191637600,0.44947735191637600
2021-01-11,2021,1,202,164,1,367,0.5504087193460490,0.5504087193460490
2021-01-12,2021,1,241,255,1,497,0.48490945674044300,0.48490945674044300
2021-01-13,2021,1,237,297,1,535,0.44299065420560700,0.44299065420560700
2021-01-14,2021,1,220,284,0,504,0.4365079365079370,0.4365079365079370
2021-01-15,2021,1,234,268,2,504,0.4642857142857140,0.4642857142857140
2021-01-16,2021,1,174,223,2,399,0.43609022556391000,0.43609022556391000
2021-01-17,2021,1,111,179,1,291,0.38144329896907200,0.38144329896907200
2021-01-18,2021,1,195,185,0,380,0.5131578947368420,0.5131578947368420
2021-01-19,2021,1,243,269,1,513,0.47368421052631600,0.47368421052631600
2021-01-20,2021,1,259,296,0,555,0.4666666666666670,0.4666666666666670
2021-01-21,2021,1,250,297,0,547,0.4570383912248630,0.4570383912248630
2021-01-22,2021,1,279,249,2,530,0.5264150943396230,0.5264150943396230
2021-01-23,2021,1,168,208,0,376,0.44680851063829800,0.44680851063829800
2021-01-24,2021,1,156,171,0,327,0.47706422018348600,0.47706422018348600
2021-01-25,2021,1,165,162,1,328,0.5030487804878050,0.5030487804878050
2021-01-26,2021,1,192,235,2,429,0.44755244755244800,0.44755244755244800
2021-01-27,2021,1,234,323,0,557,0.42010771992818700,0.42010771992818700
2021-01-28,2021,1,218,237,2,457,0.47702407002188200,0.47702407002188200
2021-01-29,2021,1,159,191,1,351,0.452991452991453,0.452991452991453
2021-01-30,2021,1,117,171,0,288,0.40625,0.40625
2021-01-31,2021,1,108,191,2,301,0.3588039867109640,0.3588039867109640
2021-02-01,2021,2,60,79,0,139,0.4316546762589930,0.4316546762589930
2021-02-02,2021,2,127,144,1,272,0.46691176470588200,0.46691176470588200
2021-02-03,2021,2,263,261,0,524,0.5019083969465650,0.5019083969465650
2021-02-04,2021,2,310,299,1,610,0.5081967213114750,0.5081967213114750
2021-02-05,2021,2,218,244,2,464,0.4698275862068970,0.4698275862068970
2021-02-06,2021,2,170,214,1,385,0.44155844155844200,0.44155844155844200
2021-02-07,2021,2,96,174,0,270,0.35555555555555600,0.35555555555555600
2021-02-08,2021,2,168,189,0,357,0.47058823529411800,0.47058823529411800
2021-02-09,2021,2,224,271,0,495,0.45252525252525300,0.45252525252525300
2021-02-10,2021,2,274,262,0,536,0.5111940298507460,0.5111940298507460
2021-02-11,2021,2,233,261,2,496,0.46975806451612900,0.46975806451612900
2021-02-12,2021,2,242,254,2,498,0.4859437751004020,0.4859437751004020
2021-02-13,2021,2,130,198,2,330,0.3939393939393940,0.3939393939393940
2021-02-14,2021,2,102,153,1,256,0.3984375,0.3984375
2021-02-15,2021,2,132,163,0,295,0.44745762711864400,0.44745762711864400
2021-02-16,2021,2,234,258,2,494,0.47368421052631600,0.47368421052631600
2021-02-17,2021,2,271,304,0,575,0.47130434782608700,0.47130434782608700
2021-02-18,2021,2,153,170,1,324,0.4722222222222220,0.4722222222222220
2021-02-19,2021,2,187,220,2,409,0.4572127139364300,0.4572127139364300
2021-02-20,2021,2,152,234,0,386,0.39378238341968900,0.39378238341968900
2021-02-21,2021,2,125,178,3,306,0.4084967320261440,0.4084967320261440
2021-02-22,2021,2,198,173,0,371,0.5336927223719680,0.5336927223719680
2021-02-23,2021,2,217,272,1,490,0.44285714285714300,0.44285714285714300
2021-02-24,2021,2,270,298,3,571,0.47285464098073600,0.47285464098073600
2021-02-25,2021,2,286,269,1,556,0.5143884892086330,0.5143884892086330
2021-02-26,2021,2,184,262,0,446,0.4125560538116590,0.4125560538116590
2021-02-27,2021,2,137,175,1,313,0.43769968051118200,0.43769968051118200
2021-02-28,2021,2,118,234,1,353,0.3342776203966010,0.3342776203966010
2021-03-01,2021,3,186,228,0,414,0.4492753623188410,0.4492753623188410
2021-03-02,2021,3,269,294,1,564,0.4769503546099290,0.4769503546099290
2021-03-03,2021,3,250,332,1,583,0.4288164665523160,0.4288164665523160
2021-03-04,2021,3,277,291,0,568,0.4876760563380280,0.4876760563380280
2021-03-05,2021,3,228,299,2,529,0.43100189035916800,0.43100189035916800
2021-03-06,2021,3,138,258,0,396,0.3484848484848490,0.3484848484848490
2021-03-07,2021,3,156,211,1,368,0.42391304347826100,0.42391304347826100
2021-03-08,2021,3,178,218,2,398,0.4472361809045230,0.4472361809045230
2021-03-09,2021,3,276,281,1,558,0.4946236559139790,0.4946236559139790
2021-03-10,2021,3,298,319,2,619,0.481421647819063,0.481421647819063
2021-03-11,2021,3,284,283,0,567,0.5008818342151680,0.5008818342151680
2021-03-12,2021,3,239,298,3,540,0.4425925925925930,0.4425925925925930
2021-03-13,2021,3,163,233,0,396,0.4116161616161620,0.4116161616161620
2021-03-14,2021,3,150,185,1,336,0.44642857142857100,0.44642857142857100
2021-03-15,2021,3,174,192,1,367,0.47411444141689400,0.47411444141689400
2021-03-16,2021,3,273,260,0,533,0.5121951219512200,0.5121951219512200
2021-03-17,2021,3,249,286,1,536,0.46455223880597000,0.46455223880597000
2021-03-18,2021,3,235,270,0,505,0.46534653465346500,0.46534653465346500
2021-03-19,2021,3,181,246,0,427,0.4238875878220140,0.4238875878220140
2021-03-20,2021,3,158,228,1,387,0.4082687338501290,0.4082687338501290
2021-03-21,2021,3,136,213,1,350,0.38857142857142900,0.38857142857142900
2021-03-22,2021,3,192,214,1,407,0.47174447174447200,0.47174447174447200
2021-03-23,2021,3,235,277,1,513,0.4580896686159840,0.4580896686159840
2021-03-24,2021,3,214,261,2,477,0.44863731656184500,0.44863731656184500
2021-03-25,2021,3,203,276,1,480,0.42291666666666700,0.42291666666666700
2021-03-26,2021,3,176,220,3,399,0.44110275689223100,0.44110275689223100
2021-03-27,2021,3,115,184,0,299,0.38461538461538500,0.38461538461538500
2021-03-28,2021,3,89,169,0,258,0.3449612403100780,0.3449612403100780
2021-03-29,2021,3,133,169,0,302,0.44039735099337700,0.44039735099337700
2021-03-30,2021,3,197,221,1,419,0.4701670644391410,0.4701670644391410
2021-03-31,2021,3,162,166,1,329,0.49240121580547100,0.49240121580547100
2021-04-01,2021,4,230,254,1,485,0.4742268041237110,0.4742268041237110
2021-04-02,2021,4,164,191,1,356,0.4606741573033710,0.4606741573033710
2021-04-03,2021,4,87,159,3,249,0.3493975903614460,0.3493975903614460
2021-04-04,2021,4,103,138,1,242,0.4256198347107440,0.4256198347107440
2021-04-05,2021,4,145,155,1,301,0.48172757475083100,0.48172757475083100
2021-04-06,2021,4,183,229,1,413,0.4430992736077480,0.4430992736077480
2021-04-07,2021,4,236,295,3,534,0.4419475655430710,0.4419475655430710
2021-04-08,2021,4,221,250,0,471,0.4692144373673040,0.4692144373673040
2021-04-09,2021,4,182,171,2,355,0.5126760563380280,0.5126760563380280
2021-04-10,2021,4,138,206,2,346,0.3988439306358380,0.3988439306358380
2021-04-11,2021,4,82,182,0,264,0.3106060606060610,0.3106060606060610
2021-04-12,2021,4,135,156,0,291,0.4639175257731960,0.4639175257731960
2021-04-13,2021,4,216,241,0,457,0.4726477024070020,0.4726477024070020
2021-04-14,2021,4,240,236,2,478,0.502092050209205,0.502092050209205
2021-04-15,2021,4,183,177,0,360,0.5083333333333330,0.5083333333333330
2021-04-16,2021,4,136,178,0,314,0.43312101910828000,0.43312101910828000
2021-04-17,2021,4,107,149,0,256,0.41796875,0.41796875
2021-04-18,2021,4,74,167,0,241,0.3070539419087140,0.3070539419087140
2021-04-19,2021,4,142,163,1,306,0.46405228758169900,0.46405228758169900
2021-04-20,2021,4,149,207,1,357,0.4173669467787120,0.4173669467787120
2021-04-21,2021,4,180,204,1,385,0.4675324675324680,0.4675324675324680
2021-04-22,2021,4,164,174,0,338,0.48520710059171600,0.48520710059171600
2021-04-23,2021,4,98,168,1,267,0.36704119850187300,0.36704119850187300
2021-04-24,2021,4,111,160,1,272,0.40808823529411800,0.40808823529411800
2021-04-25,2021,4,111,145,0,256,0.43359375,0.43359375
2021-04-26,2021,4,98,131,0,229,0.4279475982532750,0.4279475982532750
2021-04-27,2021,4,186,203,0,389,0.4781491002570690,0.4781491002570690
2021-04-28,2021,4,187,218,1,406,0.4605911330049260,0.4605911330049260
2021-04-29,2021,4,196,190,0,386,0.5077720207253890,0.5077720207253890
2021-04-30,2021,4,132,148,2,282,0.46808510638297900,0.46808510638297900
2021-05-01,2021,5,105,155,1,261,0.40229885057471300,0.40229885057471300
2021-05-02,2021,5,114,130,0,244,0.4672131147540980,0.4672131147540980
2021-05-03,2021,5,165,163,0,328,0.5030487804878050,0.5030487804878050
2021-05-04,2021,5,153,163,0,316,0.48417721518987300,0.48417721518987300
2021-05-05,2021,5,266,244,1,511,0.5205479452054790,0.5205479452054790
2021-05-06,2021,5,218,229,3,450,0.48444444444444400,0.48444444444444400
2021-05-07,2021,5,191,198,3,392,0.4872448979591840,0.4872448979591840
2021-05-08,2021,5,136,181,1,318,0.4276729559748430,0.4276729559748430
2021-05-09,2021,5,95,166,0,261,0.36398467432950200,0.36398467432950200
2021-05-10,2021,5,192,184,0,376,0.5106382978723400,0.5106382978723400
2021-05-11,2021,5,261,238,1,500,0.522,0.522
2021-05-12,2021,5,243,246,0,489,0.49693251533742300,0.49693251533742300
2021-05-13,2021,5,232,235,1,468,0.49572649572649600,0.49572649572649600
2021-05-14,2021,5,162,204,3,369,0.43902439024390200,0.43902439024390200
2021-05-15,2021,5,150,178,3,331,0.45317220543806600,0.45317220543806600
2021-05-16,2021,5,107,208,1,316,0.33860759493670900,0.33860759493670900
2021-05-17,2021,5,130,175,2,307,0.4234527687296420,0.4234527687296420
2021-05-18,2021,5,242,253,0,495,0.4888888888888890,0.4888888888888890
2021-05-19,2021,5,277,273,5,555,0.4990990990990990,0.4990990990990990
2021-05-20,2021,5,243,242,0,485,0.5010309278350520,0.5010309278350520
2021-05-21,2021,5,188,221,2,411,0.45742092457420900,0.45742092457420900
2021-05-22,2021,5,164,190,0,354,0.4632768361581920,0.4632768361581920
2021-05-23,2021,5,118,193,1,312,0.3782051282051280,0.3782051282051280
2021-05-24,2021,5,150,213,1,364,0.41208791208791200,0.41208791208791200
2021-05-25,2021,5,226,279,1,506,0.44664031620553400,0.44664031620553400
2021-05-26,2021,5,225,230,1,456,0.4934210526315790,0.4934210526315790
2021-05-27,2021,5,193,222,1,416,0.4639423076923080,0.4639423076923080
2021-05-28,2021,5,147,184,0,331,0.44410876132930500,0.44410876132930500
2021-05-29,2021,5,90,147,1,238,0.37815126050420200,0.37815126050420200
2021-05-30,2021,5,95,138,0,233,0.40772532188841200,0.40772532188841200
2021-05-31,2021,5,109,189,0,298,0.36577181208053700,0.36577181208053700
2021-06-01,2021,6,243,290,0,533,0.45590994371482200,0.45590994371482200
2021-06-02,2021,6,267,281,2,550,0.48545454545454500,0.48545454545454500
2021-06-03,2021,6,291,263,0,554,0.5252707581227440,0.5252707581227440
2021-06-04,2021,6,192,210,1,403,0.47642679900744400,0.47642679900744400
2021-06-05,2021,6,134,196,2,332,0.4036144578313250,0.4036144578313250
2021-06-06,2021,6,134,197,1,332,0.4036144578313250,0.4036144578313250
2021-06-07,2021,6,164,204,0,368,0.44565217391304300,0.44565217391304300
2021-06-08,2021,6,246,253,1,500,0.492,0.492
2021-06-09,2021,6,292,312,3,607,0.48105436573311400,0.48105436573311400
2021-06-10,2021,6,300,311,0,611,0.4909983633387890,0.4909983633387890
2021-06-11,2021,6,175,192,1,368,0.47554347826087000,0.47554347826087000
2021-06-12,2021,6,132,192,2,326,0.4049079754601230,0.4049079754601230
2021-06-13,2021,6,97,197,0,294,0.3299319727891160,0.3299319727891160
2021-06-14,2021,6,185,193,0,378,0.4894179894179890,0.4894179894179890
2021-06-15,2021,6,237,207,0,444,0.5337837837837840,0.5337837837837840
2021-06-16,2021,6,269,302,1,572,0.47027972027972000,0.47027972027972000
2021-06-17,2021,6,275,277,2,554,0.4963898916967510,0.4963898916967510
2021-06-18,2021,6,215,238,0,453,0.4746136865342160,0.4746136865342160
2021-06-19,2021,6,147,192,1,340,0.4323529411764710,0.4323529411764710
2021-06-20,2021,6,130,158,1,289,0.44982698961937700,0.44982698961937700
2021-06-21,2021,6,178,199,1,378,0.4708994708994710,0.4708994708994710
2021-06-22,2021,6,154,217,0,371,0.41509433962264200,0.41509433962264200
2021-06-23,2021,6,243,295,1,539,0.45083487940630800,0.45083487940630800
2021-06-24,2021,6,229,256,3,488,0.4692622950819670,0.4692622950819670
2021-06-25,2021,6,190,179,0,369,0.5149051490514910,0.5149051490514910
2021-06-26,2021,6,146,183,0,329,0.44376899696048600,0.44376899696048600
2021-06-27,2021,6,83,163,1,247,0.3360323886639680,0.3360323886639680
2021-06-28,2021,6,104,176,0,280,0.37142857142857100,0.37142857142857100
2021-06-29,2021,6,186,267,0,453,0.4105960264900660,0.4105960264900660
2021-06-30,2021,6,203,252,0,455,0.4461538461538460,0.4461538461538460
2021-07-01,2021,7,293,233,1,527,0.5559772296015180,0.5559772296015180
2021-07-02,2021,7,176,234,1,411,0.4282238442822380,0.4282238442822380
2021-07-03,2021,7,179,184,0,363,0.4931129476584020,0.4931129476584020
2021-07-04,2021,7,118,134,0,252,0.46825396825396800,0.46825396825396800
2021-07-05,2021,7,159,192,2,353,0.45042492917847000,0.45042492917847000
2021-07-06,2021,7,237,220,4,461,0.5140997830802600,0.5140997830802600
2021-07-07,2021,7,221,268,1,490,0.45102040816326500,0.45102040816326500
2021-07-08,2021,7,299,277,1,577,0.5181975736568460,0.5181975736568460
2021-07-09,2021,7,180,198,2,380,0.47368421052631600,0.47368421052631600
2021-07-10,2021,7,137,199,1,337,0.4065281899109790,0.4065281899109790
2021-07-11,2021,7,133,171,0,304,0.4375,0.4375
2021-07-12,2021,7,175,226,0,401,0.43640897755611000,0.43640897755611000
2021-07-13,2021,7,248,269,1,518,0.47876447876447900,0.47876447876447900
2021-07-14,2021,7,313,316,2,631,0.4960380348652930,0.4960380348652930
2021-07-15,2021,7,255,270,1,526,0.4847908745247150,0.4847908745247150
2021-07-16,2021,7,214,209,1,424,0.5047169811320760,0.5047169811320760
2021-07-17,2021,7,141,199,0,340,0.4147058823529410,0.4147058823529410
2021-07-18,2021,7,142,191,0,333,0.4264264264264260,0.4264264264264260
2021-07-19,2021,7,189,210,1,400,0.4725,0.4725
2021-07-20,2021,7,238,275,2,515,0.4621359223300970,0.4621359223300970
2021-07-21,2021,7,255,273,0,528,0.48295454545454500,0.48295454545454500
2021-07-22,2021,7,312,304,2,618,0.5048543689320390,0.5048543689320390
2021-07-23,2021,7,195,223,1,419,0.46539379474940300,0.46539379474940300
2021-07-24,2021,7,146,257,4,407,0.35872235872235900,0.35872235872235900
2021-07-25,2021,7,145,220,0,365,0.3972602739726030,0.3972602739726030
2021-07-26,2021,7,173,228,0,401,0.4314214463840400,0.4314214463840400
2021-07-27,2021,7,236,234,2,472,0.5,0.5
2021-07-28,2021,7,227,273,3,503,0.45129224652087500,0.45129224652087500
2021-07-29,2021,7,243,282,2,527,0.46110056925996200,0.46110056925996200
2021-07-30,2021,7,142,173,0,315,0.4507936507936510,0.4507936507936510
2021-07-31,2021,7,139,202,1,342,0.4064327485380120,0.4064327485380120
2021-08-01,2021,8,136,184,1,321,0.4236760124610590,0.4236760124610590
2021-08-02,2021,8,151,216,0,367,0.4114441416893730,0.4114441416893730
2021-08-03,2021,8,252,219,3,474,0.5316455696202530,0.5316455696202530
2021-08-04,2021,8,291,298,1,590,0.49322033898305100,0.49322033898305100
2021-08-05,2021,8,297,258,0,555,0.5351351351351350,0.5351351351351350
2021-08-06,2021,8,212,234,2,448,0.4732142857142860,0.4732142857142860
2021-08-07,2021,8,163,212,1,376,0.43351063829787200,0.43351063829787200
2021-08-08,2021,8,110,204,0,314,0.3503184713375800,0.3503184713375800
2021-08-09,2021,8,177,238,0,415,0.42650602409638600,0.42650602409638600
2021-08-10,2021,8,271,265,1,537,0.5046554934823090,0.5046554934823090
2021-08-11,2021,8,280,276,2,558,0.5017921146953410,0.5017921146953410
2021-08-12,2021,8,262,291,0,553,0.47377938517179000,0.47377938517179000
2021-08-13,2021,8,231,251,3,485,0.4762886597938140,0.4762886597938140
2021-08-14,2021,8,176,230,0,406,0.43349753694581300,0.43349753694581300
2021-08-15,2021,8,131,213,1,345,0.37971014492753600,0.37971014492753600
2021-08-16,2021,8,166,182,2,350,0.4742857142857140,0.4742857142857140
2021-08-17,2021,8,283,253,2,538,0.5260223048327140,0.5260223048327140
2021-08-18,2021,8,245,289,2,536,0.457089552238806,0.457089552238806
2021-08-19,2021,8,301,307,3,611,0.49263502454991800,0.49263502454991800
2021-08-20,2021,8,207,220,0,427,0.4847775175644030,0.4847775175644030
2021-08-21,2021,8,135,179,3,317,0.42586750788643500,0.42586750788643500
2021-08-22,2021,8,121,157,1,279,0.4336917562724010,0.4336917562724010
2021-08-23,2021,8,155,184,1,340,0.45588235294117600,0.45588235294117600
2021-08-24,2021,8,240,262,0,502,0.47808764940239000,0.47808764940239000
2021-08-25,2021,8,270,278,1,549,0.4918032786885250,0.4918032786885250
2021-08-26,2021,8,261,261,1,523,0.49904397705544900,0.49904397705544900
2021-08-27,2021,8,177,194,0,371,0.477088948787062,0.477088948787062
2021-08-28,2021,8,135,204,0,339,0.39823008849557500,0.39823008849557500
2021-08-29,2021,8,154,208,3,365,0.42191780821917800,0.42191780821917800
2021-08-30,2021,8,155,202,1,358,0.4329608938547490,0.4329608938547490
2021-08-31,2021,8,204,237,0,441,0.46258503401360500,0.46258503401360500
2021-09-01,2021,9,256,250,2,508,0.5039370078740160,0.5039370078740160
2021-09-02,2021,9,196,213,1,410,0.47804878048780500,0.47804878048780500
2021-09-03,2021,9,215,204,3,422,0.509478672985782,0.509478672985782
2021-09-04,2021,9,147,221,0,368,0.39945652173913000,0.39945652173913000
2021-09-05,2021,9,134,200,0,334,0.40119760479041900,0.40119760479041900
2021-09-06,2021,9,133,184,0,317,0.4195583596214510,0.4195583596214510
2021-09-07,2021,9,236,262,2,500,0.472,0.472
2021-09-08,2021,9,281,275,2,558,0.503584229390681,0.503584229390681
2021-09-09,2021,9,209,240,2,451,0.4634146341463420,0.4634146341463420
2021-09-10,2021,9,177,246,0,423,0.41843971631205700,0.41843971631205700
2021-09-11,2021,9,144,199,0,343,0.4198250728862970,0.4198250728862970
2021-09-12,2021,9,147,212,2,361,0.407202216066482,0.407202216066482
2021-09-13,2021,9,192,190,1,383,0.5013054830287210,0.5013054830287210
2021-09-14,2021,9,242,249,3,494,0.4898785425101220,0.4898785425101220
2021-09-15,2021,9,300,282,1,583,0.5145797598627790,0.5145797598627790
2021-09-16,2021,9,248,321,1,570,0.43508771929824600,0.43508771929824600
2021-09-17,2021,9,215,278,6,499,0.4308617234468940,0.4308617234468940
2021-09-18,2021,9,145,256,0,401,0.36159600997506200,0.36159600997506200
2021-09-19,2021,9,124,223,2,349,0.3553008595988540,0.3553008595988540
2021-09-20,2021,9,175,190,1,366,0.4781420765027320,0.4781420765027320
2021-09-21,2021,9,385,308,2,695,0.5539568345323740,0.5539568345323740
2021-09-22,2021,9,250,267,1,518,0.4826254826254830,0.4826254826254830
2021-09-23,2021,9,235,234,0,469,0.5010660980810230,0.5010660980810230
2021-09-24,2021,9,199,247,1,447,0.4451901565995530,0.4451901565995530
2021-09-25,2021,9,156,218,2,376,0.4148936170212770,0.4148936170212770
2021-09-26,2021,9,149,194,0,343,0.43440233236151600,0.43440233236151600
2021-09-27,2021,9,242,234,0,476,0.5084033613445380,0.5084033613445380
2021-09-28,2021,9,257,260,0,517,0.49709864603481600,0.49709864603481600
2021-09-29,2021,9,291,280,1,572,0.5087412587412590,0.5087412587412590
2021-09-30,2021,9,287,246,0,533,0.5384615384615380,0.5384615384615380
2021-10-01,2021,10,216,238,2,456,0.47368421052631600,0.47368421052631600
2021-10-02,2021,10,153,224,2,379,0.40369393139841700,0.40369393139841700
2021-10-03,2021,10,146,217,2,365,0.4,0.4
2021-10-04,2021,10,219,240,0,459,0.477124183006536,0.477124183006536
2021-10-05,2021,10,257,303,0,560,0.4589285714285710,0.4589285714285710
2021-10-06,2021,10,298,330,1,629,0.4737678855325910,0.4737678855325910
2021-10-07,2021,10,309,282,2,593,0.521079258010118,0.521079258010118
2021-10-08,2021,10,196,266,4,466,0.4206008583690990,0.4206008583690990
2021-10-09,2021,10,189,223,0,412,0.4587378640776700,0.4587378640776700
2021-10-10,2021,10,104,210,3,317,0.3280757097791800,0.3280757097791800
2021-10-11,2021,10,179,223,3,405,0.4419753086419750,0.4419753086419750
2021-10-12,2021,10,256,262,2,520,0.49230769230769200,0.49230769230769200
2021-10-13,2021,10,358,315,2,675,0.5303703703703700,0.5303703703703700
2021-10-14,2021,10,308,300,3,611,0.5040916530278230,0.5040916530278230
2021-10-15,2021,10,227,249,4,480,0.47291666666666700,0.47291666666666700
2021-10-16,2021,10,173,245,0,418,0.4138755980861240,0.4138755980861240
2021-10-17,2021,10,163,222,5,390,0.41794871794871800,0.41794871794871800
2021-10-18,2021,10,169,208,0,377,0.4482758620689660,0.4482758620689660
2021-10-19,2021,10,317,301,1,619,0.5121163166397420,0.5121163166397420
2021-10-20,2021,10,261,321,0,582,0.4484536082474230,0.4484536082474230
2021-10-21,2021,10,281,317,1,599,0.4691151919866440,0.4691151919866440
2021-10-22,2021,10,212,260,0,472,0.4491525423728810,0.4491525423728810
2021-10-23,2021,10,142,258,0,400,0.355,0.355
2021-10-24,2021,10,141,214,1,356,0.3960674157303370,0.3960674157303370
2021-10-25,2021,10,171,221,1,393,0.4351145038167940,0.4351145038167940
2021-10-26,2021,10,240,213,2,455,0.5274725274725280,0.5274725274725280
2021-10-27,2021,10,291,216,2,509,0.5717092337917490,0.5717092337917490
2021-10-28,2021,10,204,229,1,434,0.4700460829493090,0.4700460829493090
2021-10-29,2021,10,158,215,2,375,0.42133333333333300,0.42133333333333300
2021-10-30,2021,10,118,189,1,308,0.38311688311688300,0.38311688311688300
2021-10-31,2021,10,139,177,2,318,0.4371069182389940,0.4371069182389940
2021-11-01,2021,11,202,224,1,427,0.47306791569086700,0.47306791569086700
2021-11-02,2021,11,213,241,1,455,0.46813186813186800,0.46813186813186800
2021-11-03,2021,11,303,319,2,624,0.4855769230769230,0.4855769230769230
2021-11-04,2021,11,290,282,0,572,0.506993006993007,0.506993006993007
2021-11-05,2021,11,231,251,2,484,0.4772727272727270,0.4772727272727270
2021-11-06,2021,11,140,200,0,340,0.4117647058823530,0.4117647058823530
2021-11-07,2021,11,151,188,1,340,0.4441176470588240,0.4441176470588240
2021-11-08,2021,11,195,203,0,398,0.4899497487437190,0.4899497487437190
2021-11-09,2021,11,276,297,1,574,0.4808362369337980,0.4808362369337980
2021-11-10,2021,11,285,290,3,578,0.4930795847750870,0.4930795847750870
2021-11-11,2021,11,278,273,1,552,0.5036231884057970,0.5036231884057970
2021-11-12,2021,11,208,246,2,456,0.45614035087719300,0.45614035087719300
2021-11-13,2021,11,144,226,0,370,0.3891891891891890,0.3891891891891890
2021-11-14,2021,11,132,222,0,354,0.3728813559322030,0.3728813559322030
2021-11-15,2021,11,149,201,1,351,0.42450142450142500,0.42450142450142500
2021-11-16,2021,11,270,273,0,543,0.4972375690607740,0.4972375690607740
2021-11-17,2021,11,319,322,0,641,0.49765990639625600,0.49765990639625600
2021-11-18,2021,11,284,231,2,517,0.5493230174081240,0.5493230174081240
2021-11-19,2021,11,235,238,2,475,0.49473684210526300,0.49473684210526300
2021-11-20,2021,11,121,209,0,330,0.36666666666666700,0.36666666666666700
2021-11-21,2021,11,130,192,0,322,0.40372670807453400,0.40372670807453400
2021-11-22,2021,11,152,235,2,389,0.390745501285347,0.390745501285347
2021-11-23,2021,11,206,197,1,404,0.5099009900990100,0.5099009900990100
2021-11-24,2021,11,149,197,1,347,0.42939481268011500,0.42939481268011500
2021-11-25,2021,11,78,115,0,193,0.40414507772020700,0.40414507772020700
2021-11-26,2021,11,142,240,1,383,0.370757180156658,0.370757180156658
2021-11-27,2021,11,165,208,0,373,0.44235924932975900,0.44235924932975900
2021-11-28,2021,11,111,225,0,336,0.33035714285714300,0.33035714285714300
2021-11-29,2021,11,133,214,0,347,0.38328530259366000,0.38328530259366000
2021-11-30,2021,11,202,278,1,481,0.41995841995842,0.41995841995842
2021-12-01,2021,12,311,280,3,594,0.5235690235690240,0.5235690235690240
2021-12-02,2021,12,276,279,1,556,0.49640287769784200,0.49640287769784200
2021-12-03,2021,12,268,262,1,531,0.504708097928437,0.504708097928437
2021-12-04,2021,12,143,203,0,346,0.41329479768786100,0.41329479768786100
2021-12-05,2021,12,140,235,1,376,0.3723404255319150,0.3723404255319150
2021-12-06,2021,12,189,224,2,415,0.45542168674698800,0.45542168674698800
2021-12-07,2021,12,261,237,2,500,0.522,0.522
2021-12-08,2021,12,276,256,3,535,0.5158878504672900,0.5158878504672900
2021-12-09,2021,12,228,269,2,499,0.45691382765531100,0.45691382765531100
2021-12-10,2021,12,231,260,2,493,0.4685598377281950,0.4685598377281950
2021-12-11,2021,12,136,253,0,389,0.3496143958868900,0.3496143958868900
2021-12-12,2021,12,119,229,1,349,0.34097421203438400,0.34097421203438400
2021-12-13,2021,12,209,182,0,391,0.5345268542199490,0.5345268542199490
2021-12-14,2021,12,295,248,0,543,0.5432780847145490,0.5432780847145490
2021-12-15,2021,12,266,256,2,524,0.5076335877862600,0.5076335877862600
2021-12-16,2021,12,228,283,2,513,0.4444444444444440,0.4444444444444440
2021-12-17,2021,12,193,268,3,464,0.41594827586206900,0.41594827586206900
2021-12-18,2021,12,140,167,3,310,0.45161290322580600,0.45161290322580600
2021-12-19,2021,12,130,187,2,319,0.40752351097178700,0.40752351097178700
2021-12-20,2021,12,151,219,1,371,0.40700808625336900,0.40700808625336900
2021-12-21,2021,12,200,237,1,438,0.45662100456621,0.45662100456621
2021-12-22,2021,12,238,238,0,476,0.5,0.5
2021-12-23,2021,12,154,167,1,322,0.4782608695652170,0.4782608695652170
2021-12-24,2021,12,75,136,1,212,0.35377358490566000,0.35377358490566000
2021-12-25,2021,12,78,103,0,181,0.430939226519337,0.430939226519337
2021-12-26,2021,12,96,143,0,239,0.401673640167364,0.401673640167364
2021-12-27,2021,12,135,144,5,284,0.4753521126760560,0.4753521126760560
2021-12-28,2021,12,151,203,0,354,0.4265536723163840,0.4265536723163840
2021-12-29,2021,12,164,200,1,365,0.44931506849315100,0.44931506849315100
2021-12-30,2021,12,161,164,0,325,0.49538461538461500,0.49538461538461500
2021-12-31,2021,12,159,172,1,332,0.4789156626506020,0.4789156626506020
2022-01-01,2022,1,131,225,1,357,0.36694677871148500,0.36694677871148500
2022-01-02,2022,1,103,157,1,261,0.3946360153256710,0.3946360153256710
2022-01-03,2022,1,135,176,0,311,0.4340836012861740,0.4340836012861740
2022-01-04,2022,1,241,189,0,430,0.5604651162790700,0.5604651162790700
2022-01-05,2022,1,270,239,3,512,0.52734375,0.52734375
2022-01-06,2022,1,281,257,0,538,0.5223048327137550,0.5223048327137550
2022-01-07,2022,1,149,214,0,363,0.41046831955922900,0.41046831955922900
2022-01-08,2022,1,186,203,3,392,0.4744897959183670,0.4744897959183670
2022-01-09,2022,1,111,199,1,311,0.35691318327974300,0.35691318327974300
2022-01-10,2022,1,162,213,1,376,0.4308510638297870,0.4308510638297870
2022-01-11,2022,1,281,254,1,536,0.5242537313432840,0.5242537313432840
2022-01-12,2022,1,270,298,0,568,0.4753521126760560,0.4753521126760560
2022-01-13,2022,1,307,275,2,584,0.5256849315068490,0.5256849315068490
2022-01-14,2022,1,250,270,3,523,0.4780114722753350,0.4780114722753350
2022-01-15,2022,1,144,222,2,368,0.391304347826087,0.391304347826087
2022-01-16,2022,1,121,175,1,297,0.4074074074074070,0.4074074074074070
2022-01-17,2022,1,170,191,1,362,0.4696132596685080,0.4696132596685080
2022-01-18,2022,1,316,271,2,589,0.5365025466893040,0.5365025466893040
2022-01-19,2022,1,306,316,1,623,0.4911717495987160,0.4911717495987160
2022-01-20,2022,1,285,322,0,607,0.4695222405271830,0.4695222405271830
2022-01-21,2022,1,247,257,4,508,0.4862204724409450,0.4862204724409450
2022-01-22,2022,1,137,216,0,353,0.3881019830028330,0.3881019830028330
2022-01-23,2022,1,144,196,0,340,0.4235294117647060,0.4235294117647060
2022-01-24,2022,1,154,177,0,331,0.4652567975830820,0.4652567975830820
2022-01-25,2022,1,289,309,1,599,0.48247078464106800,0.48247078464106800
2022-01-26,2022,1,208,259,2,469,0.44349680170575700,0.44349680170575700
2022-01-27,2022,1,218,241,0,459,0.4749455337690630,0.4749455337690630
2022-01-28,2022,1,103,145,1,249,0.41365461847389600,0.41365461847389600
2022-01-29,2022,1,96,126,1,223,0.4304932735426010,0.4304932735426010
2022-01-30,2022,1,98,144,1,243,0.40329218106995900,0.40329218106995900
2022-01-31,2022,1,150,183,0,333,0.45045045045045000,0.45045045045045000
2022-02-01,2022,2,225,293,2,520,0.4326923076923080,0.4326923076923080
2022-02-02,2022,2,140,191,0,331,0.4229607250755290,0.4229607250755290
2022-02-03,2022,2,261,305,0,566,0.46113074204947000,0.46113074204947000
2022-02-04,2022,2,236,254,1,491,0.48065173116089600,0.48065173116089600
2022-02-05,2022,2,164,294,2,460,0.3565217391304350,0.3565217391304350
2022-02-06,2022,2,153,265,1,419,0.36515513126491600,0.36515513126491600
2022-02-07,2022,2,172,205,0,377,0.4562334217506630,0.4562334217506630
2022-02-08,2022,2,304,318,0,622,0.4887459807073960,0.4887459807073960
2022-02-09,2022,2,326,375,2,703,0.46372688477951600,0.46372688477951600
2022-02-10,2022,2,307,300,4,611,0.502454991816694,0.502454991816694
2022-02-11,2022,2,263,316,4,583,0.451114922813036,0.451114922813036
2022-02-12,2022,2,219,251,2,472,0.4639830508474580,0.4639830508474580
2022-02-13,2022,2,139,205,0,344,0.40406976744186000,0.40406976744186000
2022-02-14,2022,2,202,217,0,419,0.4821002386634850,0.4821002386634850
2022-02-15,2022,2,265,348,0,613,0.43230016313213700,0.43230016313213700
2022-02-16,2022,2,311,306,2,619,0.5024232633279480,0.5024232633279480
2022-02-17,2022,2,307,363,1,671,0.45752608047690000,0.45752608047690000
2022-02-18,2022,2,253,304,2,559,0.4525939177101970,0.4525939177101970
2022-02-19,2022,2,175,243,5,423,0.41371158392435000,0.41371158392435000
2022-02-20,2022,2,146,231,0,377,0.38726790450928400,0.38726790450928400
2022-02-21,2022,2,171,217,1,389,0.43958868894601500,0.43958868894601500
2022-02-22,2022,2,264,232,1,497,0.5311871227364190,0.5311871227364190
2022-02-23,2022,2,313,343,2,658,0.4756838905775080,0.4756838905775080
2022-02-24,2022,2,280,248,1,529,0.5293005671077500,0.5293005671077500
2022-02-25,2022,2,187,223,3,413,0.45278450363196100,0.45278450363196100
2022-02-26,2022,2,162,221,1,384,0.421875,0.421875
2022-02-27,2022,2,147,220,4,371,0.39622641509434000,0.39622641509434000
2022-02-28,2022,2,205,240,1,446,0.45964125560538100,0.45964125560538100
2022-03-01,2022,3,312,313,3,628,0.4968152866242040,0.4968152866242040
2022-03-02,2022,3,350,367,3,720,0.4861111111111110,0.4861111111111110
2022-03-03,2022,3,281,328,5,614,0.4576547231270360,0.4576547231270360
2022-03-04,2022,3,269,270,3,542,0.496309963099631,0.496309963099631
2022-03-05,2022,3,158,280,4,442,0.3574660633484160,0.3574660633484160
2022-03-06,2022,3,172,254,2,428,0.40186915887850500,0.40186915887850500
2022-03-07,2022,3,224,230,1,455,0.49230769230769200,0.49230769230769200
2022-03-08,2022,3,311,319,1,631,0.4928684627575280,0.4928684627575280
2022-03-09,2022,3,259,347,1,607,0.42668863261944000,0.42668863261944000
2022-03-10,2022,3,286,403,4,693,0.4126984126984130,0.4126984126984130
2022-03-11,2022,3,257,293,2,552,0.46557971014492800,0.46557971014492800
2022-03-12,2022,3,158,238,3,399,0.39598997493734300,0.39598997493734300
2022-03-13,2022,3,112,195,0,307,0.36482084690553700,0.36482084690553700
2022-03-14,2022,3,237,254,0,491,0.48268839103869700,0.48268839103869700
2022-03-15,2022,3,266,323,2,591,0.4500846023688660,0.4500846023688660
2022-03-16,2022,3,315,376,2,693,0.45454545454545500,0.45454545454545500
2022-03-17,2022,3,243,354,4,601,0.4043261231281200,0.4043261231281200
2022-03-18,2022,3,216,281,1,498,0.43373493975903600,0.43373493975903600
2022-03-19,2022,3,158,246,2,406,0.3891625615763550,0.3891625615763550
2022-03-20,2022,3,153,244,3,400,0.3825,0.3825
2022-03-21,2022,3,230,266,1,497,0.46277665995975900,0.46277665995975900
2022-03-22,2022,3,306,340,2,648,0.4722222222222220,0.4722222222222220
2022-03-23,2022,3,284,310,2,596,0.47651006711409400,0.47651006711409400
2022-03-24,2022,3,272,294,1,567,0.47971781305114600,0.47971781305114600
2022-03-25,2022,3,257,317,4,578,0.444636678200692,0.444636678200692
2022-03-26,2022,3,179,272,3,454,0.394273127753304,0.394273127753304
2022-03-27,2022,3,146,241,1,388,0.37628865979381400,0.37628865979381400
2022-03-28,2022,3,171,211,2,384,0.4453125,0.4453125
2022-03-29,2022,3,239,336,3,578,0.4134948096885810,0.4134948096885810
2022-03-30,2022,3,284,364,0,648,0.4382716049382720,0.4382716049382720
2022-03-31,2022,3,287,362,5,654,0.43883792048929700,0.43883792048929700
2022-04-01,2022,4,278,286,2,566,0.4911660777385160,0.4911660777385160
2022-04-02,2022,4,176,231,3,410,0.4292682926829270,0.4292682926829270
2022-04-03,2022,4,176,251,1,428,0.411214953271028,0.411214953271028
2022-04-04,2022,4,221,268,0,489,0.45194274028629900,0.45194274028629900
2022-04-05,2022,4,317,358,1,676,0.46893491124260400,0.46893491124260400
2022-04-06,2022,4,315,387,7,709,0.44428772919605100,0.44428772919605100
2022-04-07,2022,4,299,346,3,648,0.46141975308642000,0.46141975308642000
2022-04-08,2022,4,254,331,7,592,0.42905405405405400,0.42905405405405400
2022-04-09,2022,4,187,284,1,472,0.3961864406779660,0.3961864406779660
2022-04-10,2022,4,202,224,1,427,0.47306791569086700,0.47306791569086700
2022-04-11,2022,4,277,286,3,566,0.48939929328621900,0.48939929328621900
2022-04-12,2022,4,293,317,1,611,0.4795417348608840,0.4795417348608840
2022-04-13,2022,4,304,357,1,662,0.459214501510574,0.459214501510574
2022-04-14,2022,4,305,332,2,639,0.47730829420970300,0.47730829420970300
2022-04-15,2022,4,208,292,2,502,0.41434262948207200,0.41434262948207200
2022-04-16,2022,4,183,250,0,433,0.4226327944572750,0.4226327944572750
2022-04-17,2022,4,89,155,1,245,0.363265306122449,0.363265306122449
2022-04-18,2022,4,156,201,2,359,0.43454038997214500,0.43454038997214500
2022-04-19,2022,4,253,326,2,581,0.4354561101549050,0.4354561101549050
2022-04-20,2022,4,281,363,0,644,0.4363354037267080,0.4363354037267080
2022-04-21,2022,4,321,354,1,676,0.47485207100591700,0.47485207100591700
2022-04-22,2022,4,231,297,2,530,0.4358490566037740,0.4358490566037740
2022-04-23,2022,4,171,236,2,409,0.4180929095354520,0.4180929095354520
2022-04-24,2022,4,143,232,1,376,0.3803191489361700,0.3803191489361700
2022-04-25,2022,4,227,264,1,492,0.4613821138211380,0.4613821138211380
2022-04-26,2022,4,305,287,2,594,0.5134680134680140,0.5134680134680140
2022-04-27,2022,4,294,366,1,661,0.44478063540090800,0.44478063540090800
2022-04-28,2022,4,270,315,5,590,0.4576271186440680,0.4576271186440680
2022-04-29,2022,4,212,259,2,473,0.44820295983086700,0.44820295983086700
2022-04-30,2022,4,161,240,3,404,0.39851485148514900,0.39851485148514900
2022-05-01,2022,5,154,282,1,437,0.3524027459954230,0.3524027459954230
2022-05-02,2022,5,197,223,5,425,0.46352941176470600,0.46352941176470600
2022-05-03,2022,5,281,352,4,637,0.4411302982731550,0.4411302982731550
2022-05-04,2022,5,333,392,8,733,0.4542974079126880,0.4542974079126880
2022-05-05,2022,5,341,351,6,698,0.4885386819484240,0.4885386819484240
2022-05-06,2022,5,269,307,0,576,0.4670138888888890,0.4670138888888890
2022-05-07,2022,5,143,208,2,353,0.40509915014164300,0.40509915014164300
2022-05-08,2022,5,147,226,1,374,0.393048128342246,0.393048128342246
2022-05-09,2022,5,231,252,1,484,0.4772727272727270,0.4772727272727270
2022-05-10,2022,5,315,297,2,614,0.5130293159609120,0.5130293159609120
2022-05-11,2022,5,352,342,5,699,0.5035765379113020,0.5035765379113020
2022-05-12,2022,5,302,343,3,648,0.4660493827160490,0.4660493827160490
2022-05-13,2022,5,286,283,1,570,0.5017543859649120,0.5017543859649120
2022-05-14,2022,5,213,243,1,457,0.4660831509846830,0.4660831509846830
2022-05-15,2022,5,138,225,0,363,0.38016528925619800,0.38016528925619800
2022-05-16,2022,5,245,270,0,515,0.47572815533980600,0.47572815533980600
2022-05-17,2022,5,318,306,4,628,0.5063694267515920,0.5063694267515920
2022-05-18,2022,5,305,317,3,625,0.488,0.488
2022-05-19,2022,5,287,322,3,612,0.46895424836601300,0.46895424836601300
2022-05-20,2022,5,223,259,3,485,0.45979381443299000,0.45979381443299000
2022-05-21,2022,5,177,268,5,450,0.3933333333333330,0.3933333333333330
2022-05-22,2022,5,147,232,1,380,0.3868421052631580,0.3868421052631580
2022-05-23,2022,5,256,275,1,532,0.48120300751879700,0.48120300751879700
2022-05-24,2022,5,279,317,1,597,0.46733668341708500,0.46733668341708500
2022-05-25,2022,5,318,340,3,661,0.481089258698941,0.481089258698941
2022-05-26,2022,5,253,346,6,605,0.41818181818181800,0.41818181818181800
2022-05-27,2022,5,218,247,2,467,0.4668094218415420,0.4668094218415420
2022-05-28,2022,5,180,244,0,424,0.42452830188679200,0.42452830188679200
2022-05-29,2022,5,135,256,2,393,0.3435114503816790,0.3435114503816790
2022-05-30,2022,5,144,220,0,364,0.3956043956043960,0.3956043956043960
2022-05-31,2022,5,227,316,5,548,0.4142335766423360,0.4142335766423360
2022-06-01,2022,6,333,357,1,691,0.48191027496382100,0.48191027496382100
2022-06-02,2022,6,310,341,4,655,0.4732824427480920,0.4732824427480920
2022-06-03,2022,6,293,290,3,586,0.5,0.5
2022-06-04,2022,6,174,290,3,467,0.37259100642398300,0.37259100642398300
2022-06-05,2022,6,172,249,1,422,0.4075829383886260,0.4075829383886260
2022-06-06,2022,6,215,258,2,475,0.45263157894736800,0.45263157894736800
2022-06-07,2022,6,320,374,3,697,0.45911047345767600,0.45911047345767600
2022-06-08,2022,6,321,359,4,684,0.4692982456140350,0.4692982456140350
2022-06-09,2022,6,293,318,2,613,0.47797716150081600,0.47797716150081600
2022-06-10,2022,6,259,262,2,523,0.49521988527724700,0.49521988527724700
2022-06-11,2022,6,187,262,0,449,0.41648106904231600,0.41648106904231600
2022-06-12,2022,6,172,236,3,411,0.41849148418491500,0.41849148418491500
2022-06-13,2022,6,260,276,2,538,0.483271375464684,0.483271375464684
2022-06-14,2022,6,275,337,1,613,0.44861337683523700,0.44861337683523700
2022-06-15,2022,6,317,328,2,647,0.4899536321483770,0.4899536321483770
2022-06-16,2022,6,323,328,4,655,0.49312977099236600,0.49312977099236600
2022-06-17,2022,6,215,286,0,501,0.4291417165668660,0.4291417165668660
2022-06-18,2022,6,164,282,1,447,0.3668903803131990,0.3668903803131990
2022-06-19,2022,6,140,182,2,324,0.43209876543209900,0.43209876543209900
2022-06-20,2022,6,170,239,0,409,0.4156479217603910,0.4156479217603910
2022-06-21,2022,6,283,316,5,604,0.4685430463576160,0.4685430463576160
2022-06-22,2022,6,302,312,4,618,0.4886731391585760,0.4886731391585760
2022-06-23,2022,6,267,329,1,597,0.4472361809045230,0.4472361809045230
2022-06-24,2022,6,253,247,2,502,0.5039840637450200,0.5039840637450200
2022-06-25,2022,6,174,252,2,428,0.40654205607476600,0.40654205607476600
2022-06-26,2022,6,153,234,0,387,0.3953488372093020,0.3953488372093020
2022-06-27,2022,6,190,237,0,427,0.4449648711943790,0.4449648711943790
2022-06-28,2022,6,202,309,0,511,0.3953033268101760,0.3953033268101760
2022-06-29,2022,6,333,335,1,669,0.4977578475336320,0.4977578475336320
2022-06-30,2022,6,302,311,4,617,0.48946515397082700,0.48946515397082700
2022-07-01,2022,7,252,320,3,575,0.43826086956521700,0.43826086956521700
2022-07-02,2022,7,191,266,0,457,0.4179431072210070,0.4179431072210070
2022-07-03,2022,7,170,252,3,425,0.4,0.4
2022-07-04,2022,7,182,217,2,401,0.4538653366583540,0.4538653366583540
2022-07-05,2022,7,264,325,5,594,0.4444444444444440,0.4444444444444440
2022-07-06,2022,7,318,331,0,649,0.4899845916795070,0.4899845916795070
2022-07-07,2022,7,311,330,2,643,0.48367029548989100,0.48367029548989100
2022-07-08,2022,7,259,294,0,553,0.46835443037974700,0.46835443037974700
2022-07-09,2022,7,177,226,2,405,0.43703703703703700,0.43703703703703700
2022-07-10,2022,7,180,240,1,421,0.42755344418052300,0.42755344418052300
2022-07-11,2022,7,171,220,0,391,0.4373401534526850,0.4373401534526850
2022-07-12,2022,7,299,333,4,636,0.470125786163522,0.470125786163522
2022-07-13,2022,7,285,346,6,637,0.4474097331240190,0.4474097331240190
2022-07-14,2022,7,299,348,1,648,0.46141975308642000,0.46141975308642000
2022-07-15,2022,7,228,267,3,498,0.4578313253012050,0.4578313253012050
2022-07-16,2022,7,182,228,5,415,0.43855421686747000,0.43855421686747000
2022-07-17,2022,7,157,248,0,405,0.38765432098765400,0.38765432098765400
2022-07-18,2022,7,223,216,2,441,0.5056689342403630,0.5056689342403630
2022-07-19,2022,7,256,339,3,598,0.4280936454849500,0.4280936454849500
2022-07-20,2022,7,254,313,3,570,0.4456140350877190,0.4456140350877190
2022-07-21,2022,7,252,258,2,512,0.4921875,0.4921875
2022-07-22,2022,7,213,240,3,456,0.46710526315789500,0.46710526315789500
2022-07-23,2022,7,221,246,1,468,0.4722222222222220,0.4722222222222220
2022-07-24,2022,7,174,247,2,423,0.41134751773049600,0.41134751773049600
2022-07-25,2022,7,195,199,1,395,0.4936708860759490,0.4936708860759490
2022-07-26,2022,7,325,246,1,572,0.5681818181818180,0.5681818181818180
2022-07-27,2022,7,280,317,2,599,0.4674457429048410,0.4674457429048410
2022-07-28,2022,7,252,335,2,589,0.42784380305602700,0.42784380305602700
2022-07-29,2022,7,195,243,1,439,0.44419134396355400,0.44419134396355400
2022-07-30,2022,7,166,257,4,427,0.38875878220140500,0.38875878220140500
2022-07-31,2022,7,137,191,0,328,0.4176829268292680,0.4176829268292680
2022-08-01,2022,8,160,208,1,369,0.43360433604336000,0.43360433604336000
2022-08-02,2022,8,241,178,1,420,0.5738095238095240,0.5738095238095240
2022-08-03,2022,8,220,222,1,443,0.4966139954853270,0.4966139954853270
2022-08-04,2022,8,284,271,0,555,0.5117117117117120,0.5117117117117120
2022-08-05,2022,8,236,246,0,482,0.4896265560165980,0.4896265560165980
2022-08-06,2022,8,187,256,4,447,0.41834451901566000,0.41834451901566000
2022-08-07,2022,8,177,257,1,435,0.4068965517241380,0.4068965517241380
2022-08-08,2022,8,196,203,0,399,0.49122807017543900,0.49122807017543900
2022-08-09,2022,8,270,315,2,587,0.4599659284497450,0.4599659284497450
2022-08-10,2022,8,297,370,3,670,0.44328358208955200,0.44328358208955200
2022-08-11,2022,8,268,302,2,572,0.46853146853146900,0.46853146853146900
2022-08-12,2022,8,244,313,2,559,0.4364937388193200,0.4364937388193200
2022-08-13,2022,8,185,221,1,407,0.45454545454545500,0.45454545454545500
2022-08-14,2022,8,195,205,2,402,0.48507462686567200,0.48507462686567200
2022-08-15,2022,8,200,238,3,441,0.45351473922902500,0.45351473922902500
2022-08-16,2022,8,274,311,2,587,0.46678023850085200,0.46678023850085200
2022-08-17,2022,8,318,282,4,604,0.5264900662251660,0.5264900662251660
2022-08-18,2022,8,264,326,2,592,0.44594594594594600,0.44594594594594600
2022-08-19,2022,8,248,262,2,512,0.484375,0.484375
2022-08-20,2022,8,182,239,1,422,0.4312796208530810,0.4312796208530810
2022-08-21,2022,8,150,201,0,351,0.42735042735042700,0.42735042735042700
2022-08-22,2022,8,195,246,0,441,0.4421768707482990,0.4421768707482990
2022-08-23,2022,8,243,327,5,575,0.4226086956521740,0.4226086956521740
2022-08-24,2022,8,259,355,3,617,0.419773095623987,0.419773095623987
2022-08-25,2022,8,267,349,6,622,0.4292604501607720,0.4292604501607720
2022-08-26,2022,8,262,256,3,521,0.5028790786948180,0.5028790786948180
2022-08-27,2022,8,201,255,1,457,0.43982494529540500,0.43982494529540500
2022-08-28,2022,8,144,231,3,378,0.38095238095238100,0.38095238095238100
2022-08-29,2022,8,203,259,0,462,0.4393939393939390,0.4393939393939390
2022-08-30,2022,8,290,349,1,640,0.453125,0.453125
2022-08-31,2022,8,267,300,3,570,0.46842105263157900,0.46842105263157900
2022-09-01,2022,9,352,331,3,686,0.5131195335276970,0.5131195335276970
2022-09-02,2022,9,220,287,5,512,0.4296875,0.4296875
2022-09-03,2022,9,211,234,1,446,0.4730941704035870,0.4730941704035870
2022-09-04,2022,9,204,219,0,423,0.48226950354609900,0.48226950354609900
2022-09-05,2022,9,160,176,0,336,0.47619047619047600,0.47619047619047600
2022-09-06,2022,9,234,287,3,524,0.44656488549618300,0.44656488549618300
2022-09-07,2022,9,388,362,3,753,0.5152722443559100,0.5152722443559100
2022-09-08,2022,9,343,286,2,631,0.5435816164817750,0.5435816164817750
2022-09-09,2022,9,248,264,1,513,0.4834307992202730,0.4834307992202730
2022-09-10,2022,9,175,219,2,396,0.44191919191919200,0.44191919191919200
2022-09-11,2022,9,139,213,2,354,0.3926553672316380,0.3926553672316380
2022-09-12,2022,9,211,205,1,417,0.5059952038369300,0.5059952038369300
2022-09-13,2022,9,284,295,3,582,0.4879725085910650,0.4879725085910650
2022-09-14,2022,9,343,400,7,750,0.4573333333333330,0.4573333333333330
2022-09-15,2022,9,268,327,4,599,0.44741235392320500,0.44741235392320500
2022-09-16,2022,9,255,275,3,533,0.47842401500938100,0.47842401500938100
2022-09-17,2022,9,175,210,4,389,0.4498714652956300,0.4498714652956300
2022-09-18,2022,9,164,224,2,390,0.4205128205128210,0.4205128205128210
2022-09-19,2022,9,172,208,0,380,0.45263157894736800,0.45263157894736800
2022-09-20,2022,9,259,322,2,583,0.444253859348199,0.444253859348199
2022-09-21,2022,9,312,308,4,624,0.5,0.5
2022-09-22,2022,9,278,259,1,538,0.516728624535316,0.516728624535316
2022-09-23,2022,9,215,264,2,481,0.446985446985447,0.446985446985447
2022-09-24,2022,9,177,230,3,410,0.4317073170731710,0.4317073170731710
2022-09-25,2022,9,155,235,2,392,0.39540816326530600,0.39540816326530600
2022-09-26,2022,9,198,219,0,417,0.4748201438848920,0.4748201438848920
2022-09-27,2022,9,301,349,4,654,0.4602446483180430,0.4602446483180430
2022-09-28,2022,9,267,334,5,606,0.4405940594059410,0.4405940594059410
2022-09-29,2022,9,406,351,1,758,0.5356200527704490,0.5356200527704490
2022-09-30,2022,9,351,257,3,611,0.574468085106383,0.574468085106383
2022-10-01,2022,10,184,243,2,429,0.4289044289044290,0.4289044289044290
2022-10-02,2022,10,134,204,1,339,0.3952802359882010,0.3952802359882010
2022-10-03,2022,10,190,227,0,417,0.4556354916067150,0.4556354916067150
2022-10-04,2022,10,363,292,1,656,0.5533536585365850,0.5533536585365850
2022-10-05,2022,10,314,373,3,690,0.45507246376811600,0.45507246376811600
2022-10-06,2022,10,342,377,4,723,0.4730290456431540,0.4730290456431540
2022-10-07,2022,10,274,266,5,545,0.5027522935779820,0.5027522935779820
2022-10-08,2022,10,202,254,3,459,0.4400871459694990,0.4400871459694990
2022-10-09,2022,10,146,216,1,363,0.4022038567493110,0.4022038567493110
2022-10-10,2022,10,180,238,2,420,0.42857142857142900,0.42857142857142900
2022-10-11,2022,10,358,360,0,718,0.4986072423398330,0.4986072423398330
2022-10-12,2022,10,335,342,1,678,0.4941002949852510,0.4941002949852510
2022-10-13,2022,10,286,384,4,674,0.42433234421365000,0.42433234421365000
2022-10-14,2022,10,231,287,1,519,0.44508670520231200,0.44508670520231200
2022-10-15,2022,10,190,279,1,470,0.40425531914893600,0.40425531914893600
2022-10-16,2022,10,142,249,2,393,0.361323155216285,0.361323155216285
2022-10-17,2022,10,180,209,3,392,0.45918367346938800,0.45918367346938800
2022-10-18,2022,10,336,332,2,670,0.5014925373134330,0.5014925373134330
2022-10-19,2022,10,468,399,2,869,0.5385500575373990,0.5385500575373990
2022-10-20,2022,10,308,346,2,656,0.4695121951219510,0.4695121951219510
2022-10-21,2022,10,266,312,4,582,0.4570446735395190,0.4570446735395190
2022-10-22,2022,10,184,258,0,442,0.416289592760181,0.416289592760181
2022-10-23,2022,10,136,198,1,335,0.4059701492537310,0.4059701492537310
2022-10-24,2022,10,230,225,3,458,0.5021834061135370,0.5021834061135370
2022-10-25,2022,10,384,389,5,778,0.493573264781491,0.493573264781491
2022-10-26,2022,10,327,390,6,723,0.45228215767634900,0.45228215767634900
2022-10-27,2022,10,295,360,6,661,0.4462934947049920,0.4462934947049920
2022-10-28,2022,10,230,364,4,598,0.38461538461538500,0.38461538461538500
2022-10-29,2022,10,203,239,1,443,0.4582392776523700,0.4582392776523700
2022-10-30,2022,10,153,263,0,416,0.36778846153846200,0.36778846153846200
2022-10-31,2022,10,161,249,3,413,0.3898305084745760,0.3898305084745760
2022-11-01,2022,11,349,336,2,687,0.5080058224163030,0.5080058224163030
2022-11-02,2022,11,358,403,4,765,0.46797385620915000,0.46797385620915000
2022-11-03,2022,11,332,403,6,741,0.44804318488529000,0.44804318488529000
2022-11-04,2022,11,288,320,3,611,0.4713584288052370,0.4713584288052370
2022-11-05,2022,11,182,232,7,421,0.4323040380047510,0.4323040380047510
2022-11-06,2022,11,176,258,2,436,0.4036697247706420,0.4036697247706420
2022-11-07,2022,11,216,247,1,464,0.46551724137931000,0.46551724137931000
2022-11-08,2022,11,293,362,4,659,0.44461305007587300,0.44461305007587300
2022-11-09,2022,11,354,401,4,759,0.466403162055336,0.466403162055336
2022-11-10,2022,11,287,361,2,650,0.44153846153846200,0.44153846153846200
2022-11-11,2022,11,251,298,2,551,0.455535390199637,0.455535390199637
2022-11-12,2022,11,232,299,2,533,0.4352720450281430,0.4352720450281430
2022-11-13,2022,11,141,215,0,356,0.3960674157303370,0.3960674157303370
2022-11-14,2022,11,215,251,2,468,0.4594017094017090,0.4594017094017090
2022-11-15,2022,11,303,307,11,621,0.48792270531401000,0.48792270531401000
2022-11-16,2022,11,337,433,7,777,0.4337194337194340,0.4337194337194340
2022-11-17,2022,11,281,383,4,668,0.42065868263473100,0.42065868263473100
2022-11-18,2022,11,235,297,3,535,0.4392523364485980,0.4392523364485980
2022-11-19,2022,11,182,277,1,460,0.39565217391304300,0.39565217391304300
2022-11-20,2022,11,132,252,0,384,0.34375,0.34375
2022-11-21,2022,11,179,245,2,426,0.42018779342723000,0.42018779342723000
2022-11-22,2022,11,265,342,9,616,0.4301948051948050,0.4301948051948050
2022-11-23,2022,11,234,315,1,550,0.4254545454545460,0.4254545454545460
2022-11-24,2022,11,102,126,1,229,0.44541484716157200,0.44541484716157200
2022-11-25,2022,11,219,300,1,520,0.42115384615384600,0.42115384615384600
2022-11-26,2022,11,202,259,3,464,0.4353448275862070,0.4353448275862070
2022-11-27,2022,11,142,254,0,396,0.35858585858585900,0.35858585858585900
2022-11-28,2022,11,189,264,1,454,0.41629955947136600,0.41629955947136600
2022-11-29,2022,11,284,396,3,683,0.4158125915080530,0.4158125915080530
2022-11-30,2022,11,277,320,5,602,0.4601328903654490,0.4601328903654490
2022-12-01,2022,12,306,373,4,683,0.4480234260614930,0.4480234260614930
2022-12-02,2022,12,257,275,3,535,0.4803738317757010,0.4803738317757010
2022-12-03,2022,12,211,273,5,489,0.43149284253578700,0.43149284253578700
2022-12-04,2022,12,166,250,5,421,0.39429928741092600,0.39429928741092600
2022-12-05,2022,12,253,238,2,493,0.513184584178499,0.513184584178499
2022-12-06,2022,12,285,311,2,598,0.4765886287625420,0.4765886287625420
2022-12-07,2022,12,295,347,2,644,0.4580745341614910,0.4580745341614910
2022-12-08,2022,12,290,388,8,686,0.4227405247813410,0.4227405247813410
2022-12-09,2022,12,241,298,5,544,0.4430147058823530,0.4430147058823530
2022-12-10,2022,12,190,295,2,487,0.39014373716632400,0.39014373716632400
2022-12-11,2022,12,127,208,1,336,0.37797619047619000,0.37797619047619000
2022-12-12,2022,12,192,223,2,417,0.460431654676259,0.460431654676259
2022-12-13,2022,12,319,348,3,670,0.4761194029850750,0.4761194029850750
2022-12-14,2022,12,274,355,0,629,0.4356120826709060,0.4356120826709060
2022-12-15,2022,12,221,255,5,481,0.4594594594594600,0.4594594594594600
2022-12-16,2022,12,226,249,6,481,0.4698544698544700,0.4698544698544700
2022-12-17,2022,12,175,282,7,464,0.3771551724137930,0.3771551724137930
2022-12-18,2022,12,135,207,1,343,0.3935860058309040,0.3935860058309040
2022-12-19,2022,12,219,217,1,437,0.5011441647597260,0.5011441647597260
2022-12-20,2022,12,285,272,3,560,0.5089285714285710,0.5089285714285710
2022-12-21,2022,12,278,305,2,585,0.4752136752136750,0.4752136752136750
2022-12-22,2022,12,216,246,2,464,0.46551724137931000,0.46551724137931000
2022-12-23,2022,12,146,184,4,334,0.437125748502994,0.437125748502994
2022-12-24,2022,12,98,119,0,217,0.45161290322580600,0.45161290322580600
2022-12-25,2022,12,95,144,1,240,0.3958333333333330,0.3958333333333330
2022-12-26,2022,12,125,201,2,328,0.38109756097561000,0.38109756097561000
2022-12-27,2022,12,221,299,6,526,0.42015209125475300,0.42015209125475300
2022-12-28,2022,12,259,356,2,617,0.419773095623987,0.419773095623987
2022-12-29,2022,12,273,348,2,623,0.43820224719101100,0.43820224719101100
2022-12-30,2022,12,218,253,2,473,0.4608879492600420,0.4608879492600420
2022-12-31,2022,12,162,193,2,357,0.453781512605042,0.453781512605042
2023-01-01,2023,1,193,236,1,430,0.44883720930232600,0.44883720930232600
2023-01-02,2023,1,188,259,1,448,0.41964285714285700,0.41964285714285700
2023-01-03,2023,1,329,325,5,659,0.4992412746585740,0.4992412746585740
2023-01-04,2023,1,383,451,4,838,0.45704057279236300,0.45704057279236300
2023-01-05,2023,1,351,423,5,779,0.45057766367137400,0.45057766367137400
2023-01-06,2023,1,260,309,5,574,0.4529616724738680,0.4529616724738680
2023-01-07,2023,1,214,309,6,529,0.4045368620037810,0.4045368620037810
2023-01-08,2023,1,169,268,2,439,0.38496583143508000,0.38496583143508000
2023-01-09,2023,1,226,279,2,507,0.4457593688362920,0.4457593688362920
2023-01-10,2023,1,366,371,1,738,0.4959349593495940,0.4959349593495940
2023-01-11,2023,1,368,461,6,835,0.4407185628742520,0.4407185628742520
2023-01-12,2023,1,311,364,6,681,0.4566813509544790,0.4566813509544790
2023-01-13,2023,1,311,392,8,711,0.43741209563994400,0.43741209563994400
2023-01-14,2023,1,237,332,5,574,0.41289198606271800,0.41289198606271800
2023-01-15,2023,1,146,212,1,359,0.40668523676880200,0.40668523676880200
2023-01-16,2023,1,190,265,2,457,0.41575492341356700,0.41575492341356700
2023-01-17,2023,1,339,446,8,793,0.4274905422446410,0.4274905422446410
2023-01-18,2023,1,390,463,1,854,0.4566744730679160,0.4566744730679160
2023-01-19,2023,1,318,367,3,688,0.4622093023255810,0.4622093023255810
2023-01-20,2023,1,270,380,5,655,0.4122137404580150,0.4122137404580150
2023-01-21,2023,1,250,317,3,570,0.43859649122807000,0.43859649122807000
2023-01-22,2023,1,127,229,3,359,0.35376044568245100,0.35376044568245100
2023-01-23,2023,1,219,275,2,496,0.4415322580645160,0.4415322580645160
2023-01-24,2023,1,317,382,3,702,0.4515669515669520,0.4515669515669520
2023-01-25,2023,1,259,363,8,630,0.4111111111111110,0.4111111111111110
2023-01-26,2023,1,348,418,7,773,0.4501940491591200,0.4501940491591200
2023-01-27,2023,1,252,273,2,527,0.4781783681214420,0.4781783681214420
2023-01-28,2023,1,203,254,1,458,0.4432314410480350,0.4432314410480350
2023-01-29,2023,1,192,251,0,443,0.43340857787810400,0.43340857787810400
2023-01-30,2023,1,195,270,1,466,0.4184549356223180,0.4184549356223180
2023-01-31,2023,1,254,373,3,630,0.4031746031746030,0.4031746031746030
2023-02-01,2023,2,380,493,3,876,0.4337899543379000,0.4337899543379000
2023-02-02,2023,2,327,491,7,825,0.39636363636363600,0.39636363636363600
2023-02-03,2023,2,266,335,4,605,0.4396694214876030,0.4396694214876030
2023-02-04,2023,2,184,286,5,475,0.3873684210526320,0.3873684210526320
2023-02-05,2023,2,158,254,4,416,0.3798076923076920,0.3798076923076920
2023-02-06,2023,2,262,274,3,539,0.48608534322820000,0.48608534322820000
2023-02-07,2023,2,284,384,5,673,0.42199108469539400,0.42199108469539400
2023-02-08,2023,2,338,492,6,836,0.4043062200956940,0.4043062200956940
2023-02-09,2023,2,315,386,2,703,0.4480796586059740,0.4480796586059740
2023-02-10,2023,2,261,386,1,648,0.4027777777777780,0.4027777777777780
2023-02-11,2023,2,239,325,0,564,0.4237588652482270,0.4237588652482270
2023-02-12,2023,2,142,230,3,375,0.37866666666666700,0.37866666666666700
2023-02-13,2023,2,238,314,3,555,0.42882882882882900,0.42882882882882900
2023-02-14,2023,2,304,303,8,615,0.4943089430894310,0.4943089430894310
2023-02-15,2023,2,338,431,4,773,0.4372574385511000,0.4372574385511000
2023-02-16,2023,2,320,410,5,735,0.43537414965986400,0.43537414965986400
2023-02-17,2023,2,269,341,0,610,0.44098360655737700,0.44098360655737700
2023-02-18,2023,2,223,317,7,547,0.4076782449725780,0.4076782449725780
2023-02-19,2023,2,147,219,5,371,0.39622641509434000,0.39622641509434000
2023-02-20,2023,2,181,281,3,465,0.38924731182795700,0.38924731182795700
2023-02-21,2023,2,306,382,3,691,0.44283646888567300,0.44283646888567300
2023-02-22,2023,2,281,409,6,696,0.40373563218390800,0.40373563218390800
2023-02-23,2023,2,283,407,3,693,0.4083694083694080,0.4083694083694080
2023-02-24,2023,2,213,282,2,497,0.42857142857142900,0.42857142857142900
2023-02-25,2023,2,173,263,5,441,0.3922902494331070,0.3922902494331070
2023-02-26,2023,2,149,235,0,384,0.3880208333333330,0.3880208333333330
2023-02-27,2023,2,196,243,0,439,0.44646924829157200,0.44646924829157200
2023-02-28,2023,2,224,288,3,515,0.4349514563106800,0.4349514563106800
2023-03-01,2023,3,352,454,5,811,0.43403205918619000,0.43403205918619000
2023-03-02,2023,3,332,446,9,787,0.4218551461245240,0.4218551461245240
2023-03-03,2023,3,307,375,0,682,0.4501466275659820,0.4501466275659820
2023-03-04,2023,3,164,285,1,450,0.36444444444444400,0.36444444444444400
2023-03-05,2023,3,174,287,1,462,0.37662337662337700,0.37662337662337700
2023-03-06,2023,3,247,298,3,548,0.45072992700729900,0.45072992700729900
2023-03-07,2023,3,297,405,7,709,0.41889985895627600,0.41889985895627600
2023-03-08,2023,3,365,451,3,819,0.4456654456654460,0.4456654456654460
2023-03-09,2023,3,351,406,7,764,0.4594240837696340,0.4594240837696340
2023-03-10,2023,3,235,356,3,594,0.3956228956228960,0.3956228956228960
2023-03-11,2023,3,200,327,3,530,0.37735849056603800,0.37735849056603800
2023-03-12,2023,3,144,259,2,405,0.35555555555555600,0.35555555555555600
2023-03-13,2023,3,191,208,2,401,0.4763092269326680,0.4763092269326680
2023-03-14,2023,3,295,340,5,640,0.4609375,0.4609375
2023-03-15,2023,3,390,395,6,791,0.49304677623261700,0.49304677623261700
2023-03-16,2023,3,344,399,6,749,0.45927903871829100,0.45927903871829100
2023-03-17,2023,3,240,350,4,594,0.40404040404040400,0.40404040404040400
2023-03-18,2023,3,200,336,5,541,0.36968576709796700,0.36968576709796700
2023-03-19,2023,3,148,267,1,416,0.3557692307692310,0.3557692307692310
2023-03-20,2023,3,175,250,3,428,0.4088785046728970,0.4088785046728970
2023-03-21,2023,3,286,345,2,633,0.4518167456556080,0.4518167456556080
2023-03-22,2023,3,346,363,2,711,0.4866385372714490,0.4866385372714490
2023-03-23,2023,3,282,344,4,630,0.44761904761904800,0.44761904761904800
2023-03-24,2023,3,253,305,1,559,0.4525939177101970,0.4525939177101970
2023-03-25,2023,3,199,276,3,478,0.41631799163179900,0.41631799163179900
2023-03-26,2023,3,183,233,1,417,0.43884892086330900,0.43884892086330900
2023-03-27,2023,3,198,247,2,447,0.4429530201342280,0.4429530201342280
2023-03-28,2023,3,379,418,1,798,0.474937343358396,0.474937343358396
2023-03-29,2023,3,312,407,0,719,0.4339360222531290,0.4339360222531290
2023-03-30,2023,3,291,378,5,674,0.4317507418397630,0.4317507418397630
2023-03-31,2023,3,244,345,3,592,0.41216216216216200,0.41216216216216200
2023-04-01,2023,4,201,280,5,486,0.41358024691358000,0.41358024691358000
2023-04-02,2023,4,186,287,3,476,0.3907563025210080,0.3907563025210080
2023-04-03,2023,4,224,280,4,508,0.4409448818897640,0.4409448818897640
2023-04-04,2023,4,347,414,6,767,0.45241199478487600,0.45241199478487600
2023-04-05,2023,4,351,397,4,752,0.46675531914893600,0.46675531914893600
2023-04-06,2023,4,349,451,3,803,0.43462017434620200,0.43462017434620200
2023-04-07,2023,4,284,369,3,656,0.4329268292682930,0.4329268292682930
2023-04-08,2023,4,228,280,3,511,0.4461839530332680,0.4461839530332680
2023-04-09,2023,4,148,191,2,341,0.4340175953079180,0.4340175953079180
2023-04-10,2023,4,202,291,4,497,0.40643863179074400,0.40643863179074400
2023-04-11,2023,4,371,344,1,716,0.5181564245810060,0.5181564245810060
2023-04-12,2023,4,388,442,6,836,0.46411483253588500,0.46411483253588500
2023-04-13,2023,4,349,385,3,737,0.4735413839891450,0.4735413839891450
2023-04-14,2023,4,273,351,5,629,0.43402225755166900,0.43402225755166900
2023-04-15,2023,4,189,284,0,473,0.39957716701902700,0.39957716701902700
2023-04-16,2023,4,175,236,1,412,0.42475728155339800,0.42475728155339800
2023-04-17,2023,4,236,275,0,511,0.461839530332681,0.461839530332681
2023-04-18,2023,4,341,407,3,751,0.4540612516644470,0.4540612516644470
2023-04-19,2023,4,375,443,3,821,0.45676004872107200,0.45676004872107200
2023-04-20,2023,4,322,392,3,717,0.4490934449093450,0.4490934449093450
2023-04-21,2023,4,265,338,2,605,0.4380165289256200,0.4380165289256200
2023-04-22,2023,4,176,249,3,428,0.411214953271028,0.411214953271028
2023-04-23,2023,4,184,239,2,425,0.4329411764705880,0.4329411764705880
2023-04-24,2023,4,272,285,3,560,0.4857142857142860,0.4857142857142860
2023-04-25,2023,4,341,350,7,698,0.4885386819484240,0.4885386819484240
2023-04-26,2023,4,348,477,8,833,0.4177671068427370,0.4177671068427370
2023-04-27,2023,4,307,365,4,676,0.4541420118343200,0.4541420118343200
2023-04-28,2023,4,263,362,7,632,0.4161392405063290,0.4161392405063290
2023-04-29,2023,4,157,282,2,441,0.35600907029478500,0.35600907029478500
2023-04-30,2023,4,140,264,0,404,0.3465346534653470,0.3465346534653470
2023-05-01,2023,5,226,333,4,563,0.40142095914742500,0.40142095914742500
2023-05-02,2023,5,315,411,3,729,0.43209876543209900,0.43209876543209900
2023-05-03,2023,5,435,501,5,941,0.4622741764080770,0.4622741764080770
2023-05-04,2023,5,343,447,7,797,0.43036386449184400,0.43036386449184400
2023-05-05,2023,5,263,370,3,636,0.41352201257861600,0.41352201257861600
2023-05-06,2023,5,211,340,5,556,0.37949640287769800,0.37949640287769800
2023-05-07,2023,5,159,263,2,424,0.375,0.375
2023-05-08,2023,5,205,299,4,508,0.4035433070866140,0.4035433070866140
2023-05-09,2023,5,330,459,7,796,0.41457286432160800,0.41457286432160800
2023-05-10,2023,5,342,404,10,756,0.4523809523809520,0.4523809523809520
2023-05-11,2023,5,360,419,5,784,0.45918367346938800,0.45918367346938800
2023-05-12,2023,5,318,349,6,673,0.4725111441307580,0.4725111441307580
2023-05-13,2023,5,218,317,4,539,0.4044526901669760,0.4044526901669760
2023-05-14,2023,5,167,248,0,415,0.40240963855421700,0.40240963855421700
2023-05-15,2023,5,218,253,1,472,0.461864406779661,0.461864406779661
2023-05-16,2023,5,368,407,8,783,0.46998722860791800,0.46998722860791800
2023-05-17,2023,5,413,465,2,880,0.4693181818181820,0.4693181818181820
2023-05-18,2023,5,338,382,5,725,0.46620689655172400,0.46620689655172400
2023-05-19,2023,5,322,393,3,718,0.44846796657381600,0.44846796657381600
2023-05-20,2023,5,182,296,5,483,0.37681159420289900,0.37681159420289900
2023-05-21,2023,5,185,250,2,437,0.4233409610983980,0.4233409610983980
2023-05-22,2023,5,238,298,0,536,0.44402985074626900,0.44402985074626900
2023-05-23,2023,5,336,410,3,749,0.4485981308411220,0.4485981308411220
2023-05-24,2023,5,417,452,3,872,0.4782110091743120,0.4782110091743120
2023-05-25,2023,5,351,419,1,771,0.45525291828793800,0.45525291828793800
2023-05-26,2023,5,257,337,6,600,0.42833333333333300,0.42833333333333300
2023-05-27,2023,5,219,330,2,551,0.397459165154265,0.397459165154265
2023-05-28,2023,5,166,296,5,467,0.3554603854389720,0.3554603854389720
2023-05-29,2023,5,197,311,0,508,0.38779527559055100,0.38779527559055100
2023-05-30,2023,5,247,367,2,616,0.400974025974026,0.400974025974026
2023-05-31,2023,5,306,405,1,712,0.4297752808988760,0.4297752808988760
2023-06-01,2023,6,345,427,5,777,0.444015444015444,0.444015444015444
2023-06-02,2023,6,260,343,6,609,0.4269293924466340,0.4269293924466340
2023-06-03,2023,6,201,332,4,537,0.3743016759776540,0.3743016759776540
2023-06-04,2023,6,178,299,1,478,0.3723849372384940,0.3723849372384940
2023-06-05,2023,6,255,306,0,561,0.45454545454545500,0.45454545454545500
2023-06-06,2023,6,310,361,6,677,0.45790251107828700,0.45790251107828700
2023-06-07,2023,6,345,395,4,744,0.4637096774193550,0.4637096774193550
2023-06-08,2023,6,452,469,5,926,0.48812095032397400,0.48812095032397400
2023-06-09,2023,6,288,386,6,680,0.4235294117647060,0.4235294117647060
2023-06-10,2023,6,217,315,2,534,0.40636704119850200,0.40636704119850200
2023-06-11,2023,6,205,271,3,479,0.4279749478079330,0.4279749478079330
2023-06-12,2023,6,225,294,1,520,0.4326923076923080,0.4326923076923080
2023-06-13,2023,6,353,374,5,732,0.4822404371584700,0.4822404371584700
2023-06-14,2023,6,430,486,6,922,0.46637744034707200,0.46637744034707200
2023-06-15,2023,6,310,380,6,696,0.4454022988505750,0.4454022988505750
2023-06-16,2023,6,280,376,2,658,0.425531914893617,0.425531914893617
2023-06-17,2023,6,191,311,6,508,0.37598425196850400,0.37598425196850400
2023-06-18,2023,6,185,274,4,463,0.39956803455723500,0.39956803455723500
2023-06-19,2023,6,203,313,0,516,0.39341085271317800,0.39341085271317800
2023-06-20,2023,6,327,399,4,730,0.44794520547945200,0.44794520547945200
2023-06-21,2023,6,442,423,3,868,0.5092165898617510,0.5092165898617510
2023-06-22,2023,6,352,423,1,776,0.4536082474226800,0.4536082474226800
2023-06-23,2023,6,311,368,3,682,0.4560117302052790,0.4560117302052790
2023-06-24,2023,6,192,327,4,523,0.367112810707457,0.367112810707457
2023-06-25,2023,6,206,276,2,484,0.4256198347107440,0.4256198347107440
2023-06-26,2023,6,256,270,1,527,0.4857685009487670,0.4857685009487670
2023-06-27,2023,6,275,329,3,607,0.45304777594728200,0.45304777594728200
2023-06-28,2023,6,329,428,3,760,0.4328947368421050,0.4328947368421050
2023-06-29,2023,6,288,348,4,640,0.45,0.45
2023-06-30,2023,6,251,389,0,640,0.3921875,0.3921875
2023-07-01,2023,7,231,349,6,586,0.39419795221843,0.39419795221843
2023-07-02,2023,7,240,348,8,596,0.40268456375838900,0.40268456375838900
2023-07-03,2023,7,250,315,1,566,0.4416961130742050,0.4416961130742050
2023-07-04,2023,7,234,310,8,552,0.42391304347826100,0.42391304347826100
2023-07-05,2023,7,332,396,3,731,0.454172366621067,0.454172366621067
2023-07-06,2023,7,321,371,3,695,0.4618705035971220,0.4618705035971220
2023-07-07,2023,7,258,358,8,624,0.41346153846153800,0.41346153846153800
2023-07-08,2023,7,229,373,6,608,0.37664473684210500,0.37664473684210500
2023-07-09,2023,7,173,292,3,468,0.3696581196581200,0.3696581196581200
2023-07-10,2023,7,267,253,2,522,0.5114942528735630,0.5114942528735630
2023-07-11,2023,7,321,368,3,692,0.4638728323699420,0.4638728323699420
2023-07-12,2023,7,370,380,4,754,0.4907161803713530,0.4907161803713530
2023-07-13,2023,7,307,377,3,687,0.4468704512372640,0.4468704512372640
2023-07-14,2023,7,279,419,8,706,0.3951841359773370,0.3951841359773370
2023-07-15,2023,7,240,278,3,521,0.46065259117082500,0.46065259117082500
2023-07-16,2023,7,200,263,1,464,0.43103448275862100,0.43103448275862100
2023-07-17,2023,7,287,318,1,606,0.4735973597359740,0.4735973597359740
2023-07-18,2023,7,332,359,2,693,0.4790764790764790,0.4790764790764790
2023-07-19,2023,7,389,397,3,789,0.49302915082382800,0.49302915082382800
2023-07-20,2023,7,342,383,4,729,0.4691358024691360,0.4691358024691360
2023-07-21,2023,7,306,328,9,643,0.4758942457231730,0.4758942457231730
2023-07-22,2023,7,242,342,2,586,0.4129692832764510,0.4129692832764510
2023-07-23,2023,7,202,244,2,448,0.45089285714285700,0.45089285714285700
2023-07-24,2023,7,246,256,3,505,0.4871287128712870,0.4871287128712870
2023-07-25,2023,7,307,323,2,632,0.48575949367088600,0.48575949367088600
2023-07-26,2023,7,345,398,1,744,0.4637096774193550,0.4637096774193550
2023-07-27,2023,7,324,382,8,714,0.453781512605042,0.453781512605042
2023-07-28,2023,7,265,311,2,578,0.458477508650519,0.458477508650519
2023-07-29,2023,7,216,313,2,531,0.4067796610169490,0.4067796610169490
2023-07-30,2023,7,173,291,2,466,0.37124463519313300,0.37124463519313300
2023-07-31,2023,7,248,269,1,518,0.47876447876447900,0.47876447876447900
2023-08-01,2023,8,341,348,2,691,0.4934876989869750,0.4934876989869750
2023-08-02,2023,8,367,426,4,797,0.4604767879548310,0.4604767879548310
2023-08-03,2023,8,354,398,2,754,0.46949602122015900,0.46949602122015900
2023-08-04,2023,8,261,331,3,595,0.43865546218487400,0.43865546218487400
2023-08-05,2023,8,225,265,6,496,0.4536290322580650,0.4536290322580650
2023-08-06,2023,8,201,272,4,477,0.42138364779874200,0.42138364779874200
2023-08-07,2023,8,228,282,2,512,0.4453125,0.4453125
2023-08-08,2023,8,330,382,5,717,0.4602510460251050,0.4602510460251050
2023-08-09,2023,8,390,453,3,846,0.46099290780141800,0.46099290780141800
2023-08-10,2023,8,341,389,5,735,0.4639455782312930,0.4639455782312930
2023-08-11,2023,8,268,348,6,622,0.43086816720257200,0.43086816720257200
2023-08-12,2023,8,235,331,2,568,0.4137323943661970,0.4137323943661970
2023-08-13,2023,8,196,282,6,484,0.4049586776859500,0.4049586776859500
2023-08-14,2023,8,252,284,4,540,0.4666666666666670,0.4666666666666670
2023-08-15,2023,8,376,349,2,727,0.517193947730399,0.517193947730399
2023-08-16,2023,8,352,420,5,777,0.45302445302445300,0.45302445302445300
2023-08-17,2023,8,366,414,7,787,0.4650571791613720,0.4650571791613720
2023-08-18,2023,8,273,364,5,642,0.4252336448598130,0.4252336448598130
2023-08-19,2023,8,202,304,1,507,0.398422090729783,0.398422090729783
2023-08-20,2023,8,177,300,5,482,0.36721991701244800,0.36721991701244800
2023-08-21,2023,8,232,276,1,509,0.45579567779960700,0.45579567779960700
2023-08-22,2023,8,330,400,4,734,0.44959128065395100,0.44959128065395100
2023-08-23,2023,8,329,412,4,745,0.44161073825503400,0.44161073825503400
2023-08-24,2023,8,273,365,3,641,0.42589703588143500,0.42589703588143500
2023-08-25,2023,8,269,348,6,623,0.4317817014446230,0.4317817014446230
2023-08-26,2023,8,232,311,4,547,0.42413162705667300,0.42413162705667300
2023-08-27,2023,8,194,291,4,489,0.3967280163599180,0.3967280163599180
2023-08-28,2023,8,238,268,6,512,0.46484375,0.46484375
2023-08-29,2023,8,324,380,5,709,0.45698166431593800,0.45698166431593800
2023-08-30,2023,8,298,399,2,699,0.4263233190271820,0.4263233190271820
2023-08-31,2023,8,315,387,3,705,0.44680851063829800,0.44680851063829800
2023-09-01,2023,9,255,363,11,629,0.40540540540540500,0.40540540540540500
2023-09-02,2023,9,225,323,10,558,0.4032258064516130,0.4032258064516130
2023-09-03,2023,9,183,242,3,428,0.42757009345794400,0.42757009345794400
2023-09-04,2023,9,175,214,0,389,0.4498714652956300,0.4498714652956300
2023-09-05,2023,9,299,360,3,662,0.4516616314199400,0.4516616314199400
2023-09-06,2023,9,375,363,6,744,0.5040322580645160,0.5040322580645160
2023-09-07,2023,9,354,374,3,731,0.4842681258549930,0.4842681258549930
2023-09-08,2023,9,304,314,2,620,0.49032258064516100,0.49032258064516100
2023-09-09,2023,9,216,306,1,523,0.4130019120458890,0.4130019120458890
2023-09-10,2023,9,187,337,2,526,0.35551330798479100,0.35551330798479100
2023-09-11,2023,9,259,309,4,572,0.4527972027972030,0.4527972027972030
2023-09-12,2023,9,371,438,3,812,0.45689655172413800,0.45689655172413800
2023-09-13,2023,9,438,464,6,908,0.48237885462555100,0.48237885462555100
2023-09-14,2023,9,451,441,3,895,0.5039106145251400,0.5039106145251400
2023-09-15,2023,9,313,350,4,667,0.46926536731634200,0.46926536731634200
2023-09-16,2023,9,224,324,5,553,0.4050632911392410,0.4050632911392410
2023-09-17,2023,9,150,247,4,401,0.3740648379052370,0.3740648379052370
2023-09-18,2023,9,194,213,1,408,0.47549019607843100,0.47549019607843100
2023-09-19,2023,9,338,329,3,670,0.5044776119402990,0.5044776119402990
2023-09-20,2023,9,319,375,4,698,0.45702005730659000,0.45702005730659000
2023-09-21,2023,9,346,369,5,720,0.48055555555555600,0.48055555555555600
2023-09-22,2023,9,253,306,8,567,0.4462081128747800,0.4462081128747800
2023-09-23,2023,9,171,251,2,424,0.4033018867924530,0.4033018867924530
2023-09-24,2023,9,153,226,3,382,0.4005235602094240,0.4005235602094240
2023-09-25,2023,9,207,253,0,460,0.45,0.45
2023-09-26,2023,9,351,339,5,695,0.5050359712230220,0.5050359712230220
2023-09-27,2023,9,374,498,4,876,0.4269406392694060,0.4269406392694060
2023-09-28,2023,9,335,429,1,765,0.43790849673202600,0.43790849673202600
2023-09-29,2023,9,199,286,4,489,0.4069529652351740,0.4069529652351740
2023-09-30,2023,9,200,296,4,500,0.4,0.4
2023-10-01,2023,10,214,287,5,506,0.42292490118577100,0.42292490118577100
2023-10-02,2023,10,277,291,0,568,0.4876760563380280,0.4876760563380280
2023-10-03,2023,10,332,410,1,743,0.4468371467025570,0.4468371467025570
2023-10-04,2023,10,385,457,7,849,0.4534746760895170,0.4534746760895170
2023-10-05,2023,10,361,390,6,757,0.47688243064729200,0.47688243064729200
2023-10-06,2023,10,350,430,6,786,0.44529262086514000,0.44529262086514000
2023-10-07,2023,10,226,349,8,583,0.3876500857632930,0.3876500857632930
2023-10-08,2023,10,186,265,2,453,0.4105960264900660,0.4105960264900660
2023-10-09,2023,10,200,254,2,456,0.43859649122807000,0.43859649122807000
2023-10-10,2023,10,383,452,5,840,0.45595238095238100,0.45595238095238100
2023-10-11,2023,10,398,443,5,846,0.47044917257683200,0.47044917257683200
2023-10-12,2023,10,352,330,4,686,0.5131195335276970,0.5131195335276970
2023-10-13,2023,10,238,336,1,575,0.41391304347826100,0.41391304347826100
2023-10-14,2023,10,165,284,2,451,0.36585365853658500,0.36585365853658500
2023-10-15,2023,10,200,282,2,484,0.4132231404958680,0.4132231404958680
2023-10-16,2023,10,257,293,3,553,0.46473779385171800,0.46473779385171800
2023-10-17,2023,10,343,413,7,763,0.44954128440367000,0.44954128440367000
2023-10-18,2023,10,308,401,4,713,0.4319775596072930,0.4319775596072930
2023-10-19,2023,10,294,423,2,719,0.4089012517385260,0.4089012517385260
2023-10-20,2023,10,233,342,7,582,0.40034364261168400,0.40034364261168400
2023-10-21,2023,10,208,290,4,502,0.41434262948207200,0.41434262948207200
2023-10-22,2023,10,183,299,5,487,0.3757700205338810,0.3757700205338810
2023-10-23,2023,10,231,275,0,506,0.45652173913043500,0.45652173913043500
2023-10-24,2023,10,388,366,4,758,0.5118733509234830,0.5118733509234830
2023-10-25,2023,10,414,414,6,834,0.49640287769784200,0.49640287769784200
2023-10-26,2023,10,408,419,6,833,0.4897959183673470,0.4897959183673470
2023-10-27,2023,10,342,406,2,750,0.456,0.456
2023-10-28,2023,10,252,349,2,603,0.417910447761194,0.417910447761194
2023-10-29,2023,10,154,294,4,452,0.3407079646017700,0.3407079646017700
2023-10-30,2023,10,221,288,2,511,0.4324853228962820,0.4324853228962820
2023-10-31,2023,10,258,319,1,578,0.4463667820069200,0.4463667820069200
2023-11-01,2023,11,427,454,0,881,0.48467650397275800,0.48467650397275800
2023-11-02,2023,11,348,366,3,717,0.48535564853556500,0.48535564853556500
2023-11-03,2023,11,346,378,5,729,0.47462277091906700,0.47462277091906700
2023-11-04,2023,11,198,299,4,501,0.39520958083832300,0.39520958083832300
2023-11-05,2023,11,185,278,2,465,0.3978494623655910,0.3978494623655910
2023-11-06,2023,11,251,285,1,537,0.46741154562383600,0.46741154562383600
2023-11-07,2023,11,306,379,6,691,0.44283646888567300,0.44283646888567300
2023-11-08,2023,11,407,468,5,880,0.4625,0.4625
2023-11-09,2023,11,466,458,4,928,0.5021551724137930,0.5021551724137930
2023-11-10,2023,11,290,366,4,660,0.4393939393939390,0.4393939393939390
2023-11-11,2023,11,239,320,4,563,0.42451154529307300,0.42451154529307300
2023-11-12,2023,11,191,307,2,500,0.382,0.382
2023-11-13,2023,11,207,302,2,511,0.4050880626223090,0.4050880626223090
2023-11-14,2023,11,290,380,4,674,0.43026706231454000,0.43026706231454000
2023-11-15,2023,11,435,468,6,909,0.47854785478547900,0.47854785478547900
2023-11-16,2023,11,367,447,4,818,0.44865525672371600,0.44865525672371600
2023-11-17,2023,11,330,398,7,735,0.4489795918367350,0.4489795918367350
2023-11-18,2023,11,202,300,3,505,0.4,0.4
2023-11-19,2023,11,194,307,0,501,0.3872255489021960,0.3872255489021960
2023-11-20,2023,11,228,304,1,533,0.4277673545966230,0.4277673545966230
2023-11-21,2023,11,315,334,1,650,0.4846153846153850,0.4846153846153850
2023-11-22,2023,11,228,315,2,545,0.41834862385321100,0.41834862385321100
2023-11-23,2023,11,114,161,1,276,0.41304347826087000,0.41304347826087000
2023-11-24,2023,11,203,400,4,607,0.3344316309719930,0.3344316309719930
2023-11-25,2023,11,213,297,9,519,0.41040462427745700,0.41040462427745700
2023-11-26,2023,11,175,292,6,473,0.3699788583509510,0.3699788583509510
2023-11-27,2023,11,239,272,3,514,0.4649805447470820,0.4649805447470820
2023-11-28,2023,11,302,319,5,626,0.48242811501597400,0.48242811501597400
2023-11-29,2023,11,391,454,5,850,0.46,0.46
2023-11-30,2023,11,289,375,6,670,0.43134328358209000,0.43134328358209000
2023-12-01,2023,12,291,339,7,637,0.45682888540031400,0.45682888540031400
2023-12-02,2023,12,253,327,7,587,0.43100511073253800,0.43100511073253800
2023-12-03,2023,12,181,269,2,452,0.4004424778761060,0.4004424778761060
2023-12-04,2023,12,264,326,0,590,0.44745762711864400,0.44745762711864400
2023-12-05,2023,12,378,395,5,778,0.48586118251928000,0.48586118251928000
2023-12-06,2023,12,337,392,4,733,0.4597544338335610,0.4597544338335610
2023-12-07,2023,12,303,331,3,637,0.47566718995290400,0.47566718995290400
2023-12-08,2023,12,279,394,5,678,0.41150442477876100,0.41150442477876100
2023-12-09,2023,12,204,311,6,521,0.3915547024952020,0.3915547024952020
2023-12-10,2023,12,163,278,1,442,0.36877828054298600,0.36877828054298600
2023-12-11,2023,12,245,279,0,524,0.4675572519083970,0.4675572519083970
2023-12-12,2023,12,316,328,3,647,0.4884080370942810,0.4884080370942810
2023-12-13,2023,12,360,354,7,721,0.49930651872399400,0.49930651872399400
2023-12-14,2023,12,260,392,5,657,0.395738203957382,0.395738203957382
2023-12-15,2023,12,261,356,1,618,0.4223300970873790,0.4223300970873790
2023-12-16,2023,12,224,345,4,573,0.39092495636998300,0.39092495636998300
2023-12-17,2023,12,173,276,4,453,0.3818984547461370,0.3818984547461370
2023-12-18,2023,12,233,253,3,489,0.47648261758691200,0.47648261758691200
2023-12-19,2023,12,362,372,6,740,0.4891891891891890,0.4891891891891890
2023-12-20,2023,12,298,330,3,631,0.4722662440570520,0.4722662440570520
2023-12-21,2023,12,244,289,4,537,0.4543761638733710,0.4543761638733710
2023-12-22,2023,12,233,344,6,583,0.3996569468267580,0.3996569468267580
2023-12-23,2023,12,159,281,1,441,0.36054421768707500,0.36054421768707500
2023-12-24,2023,12,123,217,5,345,0.3565217391304350,0.3565217391304350
2023-12-25,2023,12,119,136,1,256,0.46484375,0.46484375
2023-12-26,2023,12,254,314,4,572,0.44405594405594400,0.44405594405594400
2023-12-27,2023,12,288,373,6,667,0.431784107946027,0.431784107946027
2023-12-28,2023,12,233,308,3,544,0.42830882352941200,0.42830882352941200
2023-12-29,2023,12,221,340,5,566,0.39045936395759700,0.39045936395759700
2023-12-30,2023,12,214,335,4,553,0.38698010849909600,0.38698010849909600
2023-12-31,2023,12,141,215,0,356,0.3960674157303370,0.3960674157303370
2024-01-01,2024,1,172,292,1,465,0.36989247311828000,0.36989247311828000
2024-01-02,2024,1,286,349,4,639,0.4475743348982790,0.4475743348982790
2024-01-03,2024,1,402,402,4,808,0.4975247524752480,0.4975247524752480
2024-01-04,2024,1,385,477,4,866,0.4445727482678980,0.4445727482678980
2024-01-05,2024,1,294,373,0,667,0.4407796101949030,0.4407796101949030
2024-01-06,2024,1,207,290,3,500,0.414,0.414
2024-01-07,2024,1,172,244,3,419,0.4105011933174220,0.4105011933174220
2024-01-08,2024,1,296,340,194,830,0.3566265060240960,0.3566265060240960
2024-01-09,2024,1,254,344,2,600,0.42333333333333300,0.42333333333333300
2024-01-10,2024,1,383,466,7,856,0.44742990654205600,0.44742990654205600
2024-01-11,2024,1,414,459,6,879,0.4709897610921500,0.4709897610921500
2024-01-12,2024,1,312,446,6,764,0.4083769633507850,0.4083769633507850
2024-01-13,2024,1,233,405,8,646,0.3606811145510840,0.3606811145510840
2024-01-14,2024,1,201,345,2,548,0.36678832116788300,0.36678832116788300
2024-01-15,2024,1,235,296,1,532,0.4417293233082710,0.4417293233082710
2024-01-16,2024,1,271,292,5,568,0.477112676056338,0.477112676056338
2024-01-17,2024,1,367,469,3,839,0.4374255065554230,0.4374255065554230
2024-01-18,2024,1,336,495,8,839,0.40047675804529200,0.40047675804529200
2024-01-19,2024,1,281,417,3,701,0.4008559201141230,0.4008559201141230
2024-01-20,2024,1,180,370,3,553,0.325497287522604,0.325497287522604
2024-01-21,2024,1,173,367,5,545,0.3174311926605510,0.3174311926605510
2024-01-22,2024,1,286,353,2,641,0.44617784711388500,0.44617784711388500
2024-01-23,2024,1,346,440,4,790,0.4379746835443040,0.4379746835443040
2024-01-24,2024,1,383,464,7,854,0.4484777517564400,0.4484777517564400
2024-01-25,2024,1,302,427,6,735,0.4108843537414970,0.4108843537414970
2024-01-26,2024,1,293,478,9,780,0.37564102564102600,0.37564102564102600
2024-01-27,2024,1,252,456,2,710,0.35492957746478900,0.35492957746478900
2024-01-28,2024,1,189,334,4,527,0.3586337760910820,0.3586337760910820
2024-01-29,2024,1,245,374,9,628,0.39012738853503200,0.39012738853503200
2024-01-30,2024,1,306,394,7,707,0.4328147100424330,0.4328147100424330
2024-01-31,2024,1,383,456,6,845,0.4532544378698230,0.4532544378698230
2024-02-01,2024,2,383,517,7,907,0.422271223814774,0.422271223814774
2024-02-02,2024,2,340,441,9,790,0.43037974683544300,0.43037974683544300
2024-02-03,2024,2,215,386,4,605,0.35537190082644600,0.35537190082644600
2024-02-04,2024,2,188,312,6,506,0.3715415019762850,0.3715415019762850
2024-02-05,2024,2,320,365,6,691,0.4630969609261940,0.4630969609261940
2024-02-06,2024,2,458,500,5,963,0.4755970924195220,0.4755970924195220
2024-02-07,2024,2,433,450,12,895,0.48379888268156400,0.48379888268156400
2024-02-08,2024,2,406,431,5,842,0.4821852731591450,0.4821852731591450
2024-02-09,2024,2,382,418,11,811,0.47102342786683100,0.47102342786683100
2024-02-10,2024,2,261,430,7,698,0.37392550143266500,0.37392550143266500
2024-02-11,2024,2,175,304,1,480,0.3645833333333330,0.3645833333333330
2024-02-12,2024,2,255,359,2,616,0.413961038961039,0.413961038961039
2024-02-13,2024,2,291,328,5,624,0.46634615384615400,0.46634615384615400
2024-02-14,2024,2,355,466,11,832,0.4266826923076920,0.4266826923076920
2024-02-15,2024,2,413,479,9,901,0.4583795782463930,0.4583795782463930
2024-02-16,2024,2,289,381,8,678,0.42625368731563400,0.42625368731563400
2024-02-17,2024,2,232,371,5,608,0.3815789473684210,0.3815789473684210
2024-02-18,2024,2,218,324,5,547,0.39853747714808000,0.39853747714808000
2024-02-19,2024,2,207,354,4,565,0.3663716814159290,0.3663716814159290
2024-02-20,2024,2,320,402,8,730,0.4383561643835620,0.4383561643835620
2024-02-21,2024,2,380,504,6,890,0.42696629213483100,0.42696629213483100
2024-02-22,2024,2,322,395,12,729,0.44170096021947900,0.44170096021947900
2024-02-23,2024,2,273,406,12,691,0.3950795947901590,0.3950795947901590
2024-02-24,2024,2,219,320,6,545,0.4018348623853210,0.4018348623853210
2024-02-25,2024,2,199,312,2,513,0.38791423001949300,0.38791423001949300
2024-02-26,2024,2,225,322,2,549,0.4098360655737710,0.4098360655737710
2024-02-27,2024,2,317,384,4,705,0.44964539007092200,0.44964539007092200
2024-02-28,2024,2,355,408,7,770,0.461038961038961,0.461038961038961
2024-02-29,2024,2,364,427,10,801,0.4544319600499380,0.4544319600499380
2024-03-01,2024,3,314,435,7,756,0.41534391534391500,0.41534391534391500
2024-03-02,2024,3,234,346,6,586,0.3993174061433450,0.3993174061433450
2024-03-03,2024,3,200,322,4,526,0.38022813688212900,0.38022813688212900
2024-03-04,2024,3,236,339,1,576,0.4097222222222220,0.4097222222222220
2024-03-05,2024,3,342,428,6,776,0.44072164948453600,0.44072164948453600
2024-03-06,2024,3,411,442,12,865,0.4751445086705200,0.4751445086705200
2024-03-07,2024,3,426,475,9,910,0.46813186813186800,0.46813186813186800
2024-03-08,2024,3,303,429,9,741,0.4089068825910930,0.4089068825910930
2024-03-09,2024,3,204,352,4,560,0.36428571428571400,0.36428571428571400
2024-03-10,2024,3,155,318,1,474,0.3270042194092830,0.3270042194092830
2024-03-11,2024,3,323,372,3,698,0.46275071633237800,0.46275071633237800
2024-03-12,2024,3,430,470,1,901,0.4772475027746950,0.4772475027746950
2024-03-13,2024,3,417,508,7,932,0.44742489270386300,0.44742489270386300
2024-03-14,2024,3,436,482,114,1032,0.42248062015503900,0.42248062015503900
2024-03-15,2024,3,289,403,2,694,0.4164265129683000,0.4164265129683000
2024-03-16,2024,3,247,370,0,617,0.40032414910859000,0.40032414910859000
2024-03-17,2024,3,185,329,2,516,0.35852713178294600,0.35852713178294600
2024-03-18,2024,3,287,342,2,631,0.4548335974643420,0.4548335974643420
2024-03-19,2024,3,376,405,6,787,0.4777636594663280,0.4777636594663280
2024-03-20,2024,3,390,443,8,841,0.4637336504161710,0.4637336504161710
2024-03-21,2024,3,359,423,1,783,0.45849297573435500,0.45849297573435500
2024-03-22,2024,3,280,406,9,695,0.4028776978417270,0.4028776978417270
2024-03-23,2024,3,182,340,5,527,0.34535104364326400,0.34535104364326400
2024-03-24,2024,3,227,377,1,605,0.3752066115702480,0.3752066115702480
2024-03-25,2024,3,249,316,1,566,0.43992932862190800,0.43992932862190800
2024-03-26,2024,3,315,394,7,716,0.4399441340782120,0.4399441340782120
2024-03-27,2024,3,361,507,12,880,0.4102272727272730,0.4102272727272730
2024-03-28,2024,3,258,344,6,608,0.4243421052631580,0.4243421052631580
2024-03-29,2024,3,253,375,2,630,0.4015873015873020,0.4015873015873020
2024-03-30,2024,3,190,267,6,463,0.4103671706263500,0.4103671706263500
2024-03-31,2024,3,145,216,2,363,0.39944903581267200,0.39944903581267200
2024-04-01,2024,4,237,316,3,556,0.4262589928057550,0.4262589928057550
2024-04-02,2024,4,294,315,6,615,0.47804878048780500,0.47804878048780500
2024-04-03,2024,4,309,385,7,701,0.44079885877318100,0.44079885877318100
2024-04-04,2024,4,321,414,9,744,0.4314516129032260,0.4314516129032260
2024-04-05,2024,4,297,397,11,705,0.42127659574468100,0.42127659574468100
2024-04-06,2024,4,215,380,6,601,0.3577371048252910,0.3577371048252910
2024-04-07,2024,4,224,307,0,531,0.4218455743879470,0.4218455743879470
2024-04-08,2024,4,261,375,6,642,0.40654205607476600,0.40654205607476600
2024-04-09,2024,4,386,462,2,850,0.4541176470588240,0.4541176470588240
2024-04-10,2024,4,408,491,4,903,0.45182724252491700,0.45182724252491700
2024-04-11,2024,4,394,424,4,822,0.4793187347931870,0.4793187347931870
2024-04-12,2024,4,285,445,8,738,0.3861788617886180,0.3861788617886180
2024-04-13,2024,4,239,421,3,663,0.36048265460030200,0.36048265460030200
2024-04-14,2024,4,209,318,5,532,0.39285714285714300,0.39285714285714300
2024-04-15,2024,4,290,419,1,710,0.4084507042253520,0.4084507042253520
2024-04-16,2024,4,432,442,6,880,0.4909090909090910,0.4909090909090910
2024-04-17,2024,4,351,484,5,840,0.41785714285714300,0.41785714285714300
2024-04-18,2024,4,315,429,3,747,0.42168674698795200,0.42168674698795200
2024-04-19,2024,4,308,446,9,763,0.4036697247706420,0.4036697247706420
2024-04-20,2024,4,219,326,7,552,0.3967391304347830,0.3967391304347830
2024-04-21,2024,4,186,297,7,490,0.3795918367346940,0.3795918367346940
2024-04-22,2024,4,218,295,7,520,0.41923076923076900,0.41923076923076900
2024-04-23,2024,4,303,413,5,721,0.420249653259362,0.420249653259362
2024-04-24,2024,4,333,408,4,745,0.4469798657718120,0.4469798657718120
2024-04-25,2024,4,289,366,5,660,0.43787878787878800,0.43787878787878800
2024-04-26,2024,4,259,385,4,648,0.39969135802469100,0.39969135802469100
2024-04-27,2024,4,264,408,4,676,0.3905325443786980,0.3905325443786980
2024-04-28,2024,4,188,288,4,480,0.39166666666666700,0.39166666666666700
2024-04-29,2024,4,241,321,2,564,0.42730496453900700,0.42730496453900700
2024-04-30,2024,4,354,406,3,763,0.4639580602883360,0.4639580602883360
2024-05-01,2024,5,418,483,4,905,0.46187845303867400,0.46187845303867400
2024-05-02,2024,5,406,496,10,912,0.4451754385964910,0.4451754385964910
2024-05-03,2024,5,300,450,6,756,0.3968253968253970,0.3968253968253970
2024-05-04,2024,5,235,311,8,554,0.42418772563176900,0.42418772563176900
2024-05-05,2024,5,166,306,4,476,0.3487394957983190,0.3487394957983190
2024-05-06,2024,5,278,274,3,555,0.5009009009009010,0.5009009009009010
2024-05-07,2024,5,389,374,3,766,0.5078328981723240,0.5078328981723240
2024-05-08,2024,5,433,505,6,944,0.4586864406779660,0.4586864406779660
2024-05-09,2024,5,375,491,4,870,0.43103448275862100,0.43103448275862100
2024-05-10,2024,5,295,404,4,703,0.41963015647226200,0.41963015647226200
2024-05-11,2024,5,248,400,7,655,0.3786259541984730,0.3786259541984730
2024-05-12,2024,5,163,275,7,445,0.36629213483146100,0.36629213483146100
2024-05-13,2024,5,250,325,2,577,0.43327556325823200,0.43327556325823200
2024-05-14,2024,5,350,405,3,758,0.46174142480211100,0.46174142480211100
2024-05-15,2024,5,367,444,4,815,0.4503067484662580,0.4503067484662580
2024-05-16,2024,5,382,484,4,870,0.43908045977011500,0.43908045977011500
2024-05-17,2024,5,290,466,9,765,0.3790849673202610,0.3790849673202610
2024-05-18,2024,5,256,380,7,643,0.39813374805598800,0.39813374805598800
2024-05-19,2024,5,197,373,4,574,0.343205574912892,0.343205574912892
2024-05-20,2024,5,258,363,2,623,0.41412520064205500,0.41412520064205500
2024-05-21,2024,5,397,415,6,818,0.48533007334963300,0.48533007334963300
2024-05-22,2024,5,351,522,8,881,0.39841089670828600,0.39841089670828600
2024-05-23,2024,5,385,417,2,804,0.47885572139303500,0.47885572139303500
2024-05-24,2024,5,306,388,2,696,0.4396551724137930,0.4396551724137930
2024-05-25,2024,5,307,451,9,767,0.4002607561929600,0.4002607561929600
2024-05-26,2024,5,195,422,5,622,0.3135048231511250,0.3135048231511250
2024-05-27,2024,5,235,363,3,601,0.3910149750415970,0.3910149750415970
2024-05-28,2024,5,348,413,4,765,0.4549019607843140,0.4549019607843140
2024-05-29,2024,5,377,395,8,780,0.48333333333333300,0.48333333333333300
2024-05-30,2024,5,321,386,8,715,0.4489510489510490,0.4489510489510490
2024-05-31,2024,5,274,439,3,716,0.38268156424581000,0.38268156424581000
2024-06-01,2024,6,249,411,4,664,0.375,0.375
2024-06-02,2024,6,247,403,4,654,0.37767584097859300,0.37767584097859300
2024-06-03,2024,6,272,359,4,635,0.4283464566929130,0.4283464566929130
2024-06-04,2024,6,456,459,6,921,0.495114006514658,0.495114006514658
2024-06-05,2024,6,351,447,3,801,0.43820224719101100,0.43820224719101100
2024-06-06,2024,6,404,450,5,859,0.470314318975553,0.470314318975553
2024-06-07,2024,6,300,458,13,771,0.38910505836575900,0.38910505836575900
2024-06-08,2024,6,280,432,6,718,0.38997214484679700,0.38997214484679700
2024-06-09,2024,6,247,331,4,582,0.42439862542955300,0.42439862542955300
2024-06-10,2024,6,300,296,3,599,0.5008347245409020,0.5008347245409020
2024-06-11,2024,6,436,458,4,898,0.48552338530066800,0.48552338530066800
2024-06-12,2024,6,415,488,4,907,0.45755237045204000,0.45755237045204000
2024-06-13,2024,6,372,475,5,852,0.43661971830985900,0.43661971830985900
2024-06-14,2024,6,270,400,13,683,0.3953147877013180,0.3953147877013180
2024-06-15,2024,6,245,412,9,666,0.36786786786786800,0.36786786786786800
2024-06-16,2024,6,219,356,6,581,0.3769363166953530,0.3769363166953530
2024-06-17,2024,6,275,350,3,628,0.43789808917197500,0.43789808917197500
2024-06-18,2024,6,345,420,7,772,0.44689119170984500,0.44689119170984500
2024-06-19,2024,6,446,519,5,970,0.45979381443299000,0.45979381443299000
2024-06-20,2024,6,361,513,1,875,0.4125714285714290,0.4125714285714290
2024-06-21,2024,6,295,412,5,712,0.4143258426966290,0.4143258426966290
2024-06-22,2024,6,282,387,3,672,0.41964285714285700,0.41964285714285700
2024-06-23,2024,6,260,382,4,646,0.4024767801857590,0.4024767801857590
2024-06-24,2024,6,296,359,2,657,0.4505327245053270,0.4505327245053270
2024-06-25,2024,6,313,413,5,731,0.42818057455540400,0.42818057455540400
2024-06-26,2024,6,348,405,6,759,0.45849802371541500,0.45849802371541500
2024-06-27,2024,6,325,444,4,773,0.4204398447606730,0.4204398447606730
2024-06-28,2024,6,270,388,4,662,0.4078549848942600,0.4078549848942600
2024-06-29,2024,6,292,348,6,646,0.4520123839009290,0.4520123839009290
2024-06-30,2024,6,215,324,4,543,0.39594843462246800,0.39594843462246800
2024-07-01,2024,7,269,323,6,598,0.4498327759197320,0.4498327759197320
2024-07-02,2024,7,429,432,2,863,0.49710312862108900,0.49710312862108900
2024-07-03,2024,7,411,459,5,875,0.4697142857142860,0.4697142857142860
2024-07-04,2024,7,271,354,3,628,0.4315286624203820,0.4315286624203820
2024-07-05,2024,7,332,486,2,820,0.40487804878048800,0.40487804878048800
2024-07-06,2024,7,280,387,11,678,0.41297935103244800,0.41297935103244800
2024-07-07,2024,7,254,383,7,644,0.3944099378881990,0.3944099378881990
2024-07-08,2024,7,302,369,2,673,0.4487369985141160,0.4487369985141160
2024-07-09,2024,7,391,439,9,839,0.466030989272944,0.466030989272944
2024-07-10,2024,7,409,431,7,847,0.48288075560802800,0.48288075560802800
2024-07-11,2024,7,410,431,6,847,0.48406139315230200,0.48406139315230200
2024-07-12,2024,7,307,418,9,734,0.41825613079019100,0.41825613079019100
2024-07-13,2024,7,306,391,7,704,0.4346590909090910,0.4346590909090910
2024-07-14,2024,7,186,365,4,555,0.33513513513513500,0.33513513513513500
2024-07-15,2024,7,247,336,2,585,0.4222222222222220,0.4222222222222220
2024-07-16,2024,7,374,421,1,796,0.46984924623115600,0.46984924623115600
2024-07-17,2024,7,425,461,1,887,0.4791431792559190,0.4791431792559190
2024-07-18,2024,7,389,420,9,818,0.47555012224938900,0.47555012224938900
2024-07-19,2024,7,202,242,1,445,0.45393258426966300,0.45393258426966300
2024-07-20,2024,7,229,390,6,625,0.3664,0.3664
2024-07-21,2024,7,273,367,4,644,0.42391304347826100,0.42391304347826100
2024-07-22,2024,7,278,371,8,657,0.4231354642313550,0.4231354642313550
2024-07-23,2024,7,322,466,4,792,0.4065656565656570,0.4065656565656570
2024-07-24,2024,7,420,471,5,896,0.46875,0.46875
2024-07-25,2024,7,376,462,10,848,0.44339622641509400,0.44339622641509400
2024-07-26,2024,7,340,425,10,775,0.43870967741935500,0.43870967741935500
2024-07-27,2024,7,198,397,9,604,0.32781456953642400,0.32781456953642400
2024-07-28,2024,7,210,326,5,541,0.38817005545286500,0.38817005545286500
2024-07-29,2024,7,272,334,4,610,0.4459016393442620,0.4459016393442620
2024-07-30,2024,7,343,429,4,776,0.4420103092783510,0.4420103092783510
2024-07-31,2024,7,351,490,4,845,0.4153846153846150,0.4153846153846150
2024-08-01,2024,8,398,540,9,947,0.42027455121436100,0.42027455121436100
2024-08-02,2024,8,318,418,12,748,0.42513368983957200,0.42513368983957200
2024-08-03,2024,8,253,426,5,684,0.36988304093567300,0.36988304093567300
2024-08-04,2024,8,239,360,4,603,0.3963515754560530,0.3963515754560530
2024-08-05,2024,8,289,368,1,658,0.439209726443769,0.439209726443769
2024-08-06,2024,8,374,377,4,755,0.495364238410596,0.495364238410596
2024-08-07,2024,8,390,494,5,889,0.43869516310461200,0.43869516310461200
2024-08-08,2024,8,379,479,11,869,0.4361334867663980,0.4361334867663980
2024-08-09,2024,8,343,455,14,812,0.4224137931034480,0.4224137931034480
2024-08-10,2024,8,280,471,6,757,0.36988110964332900,0.36988110964332900
2024-08-11,2024,8,267,400,7,674,0.3961424332344210,0.3961424332344210
2024-08-12,2024,8,300,344,5,649,0.4622496147919880,0.4622496147919880
2024-08-13,2024,8,404,433,3,840,0.48095238095238100,0.48095238095238100
2024-08-14,2024,8,405,500,6,911,0.4445664105378710,0.4445664105378710
2024-08-15,2024,8,379,466,8,853,0.44431418522860500,0.44431418522860500
2024-08-16,2024,8,330,438,12,780,0.4230769230769230,0.4230769230769230
2024-08-17,2024,8,236,368,6,610,0.38688524590163900,0.38688524590163900
2024-08-18,2024,8,198,339,2,539,0.3673469387755100,0.3673469387755100
2024-08-19,2024,8,306,398,2,706,0.43342776203966000,0.43342776203966000
2024-08-20,2024,8,322,439,9,770,0.41818181818181800,0.41818181818181800
2024-08-21,2024,8,355,485,6,846,0.41962174940898300,0.41962174940898300
2024-08-22,2024,8,325,443,5,773,0.4204398447606730,0.4204398447606730
2024-08-23,2024,8,290,382,4,676,0.4289940828402370,0.4289940828402370
2024-08-24,2024,8,231,395,5,631,0.36608557844691000,0.36608557844691000
2024-08-25,2024,8,212,354,8,574,0.3693379790940770,0.3693379790940770
2024-08-26,2024,8,238,329,4,571,0.4168126094570930,0.4168126094570930
2024-08-27,2024,8,353,386,9,748,0.47192513368984000,0.47192513368984000
2024-08-28,2024,8,342,461,6,809,0.4227441285537700,0.4227441285537700
2024-08-29,2024,8,315,431,10,756,0.4166666666666670,0.4166666666666670
2024-08-30,2024,8,266,369,9,644,0.41304347826087000,0.41304347826087000
2024-08-31,2024,8,258,379,3,640,0.403125,0.403125
2024-09-01,2024,9,223,324,2,549,0.40619307832422600,0.40619307832422600
2024-09-02,2024,9,240,301,2,543,0.4419889502762430,0.4419889502762430
2024-09-03,2024,9,287,364,5,656,0.4375,0.4375
2024-09-04,2024,9,399,431,6,836,0.4772727272727270,0.4772727272727270
2024-09-05,2024,9,392,447,7,846,0.46335697399527200,0.46335697399527200
2024-09-06,2024,9,303,397,6,706,0.42917847025495800,0.42917847025495800
2024-09-07,2024,9,223,413,5,641,0.34789391575663000,0.34789391575663000
2024-09-08,2024,9,205,336,5,546,0.37545787545787500,0.37545787545787500
2024-09-09,2024,9,347,379,6,732,0.47404371584699500,0.47404371584699500
2024-09-10,2024,9,387,425,4,816,0.4742647058823530,0.4742647058823530
2024-09-11,2024,9,345,480,3,828,0.4166666666666670,0.4166666666666670
2024-09-12,2024,9,387,482,12,881,0.4392735527809310,0.4392735527809310
2024-09-13,2024,9,322,490,9,821,0.392204628501827,0.392204628501827
2024-09-14,2024,9,276,409,10,695,0.3971223021582730,0.3971223021582730
2024-09-15,2024,9,199,355,5,559,0.3559928443649370,0.3559928443649370
2024-09-16,2024,9,302,342,5,649,0.46533127889060100,0.46533127889060100
2024-09-17,2024,9,399,460,4,863,0.4623406720741600,0.4623406720741600
2024-09-18,2024,9,490,529,5,1024,0.478515625,0.478515625
2024-09-19,2024,9,339,474,9,822,0.4124087591240880,0.4124087591240880
2024-09-20,2024,9,286,478,12,776,0.36855670103092800,0.36855670103092800
2024-09-21,2024,9,250,363,3,616,0.40584415584415600,0.40584415584415600
2024-09-22,2024,9,196,307,3,506,0.38735177865612600,0.38735177865612600
2024-09-23,2024,9,297,342,0,639,0.4647887323943660,0.4647887323943660
2024-09-24,2024,9,331,397,0,728,0.45467032967033000,0.45467032967033000
2024-09-25,2024,9,286,409,7,702,0.4074074074074070,0.4074074074074070
2024-09-26,2024,9,318,397,4,719,0.4422809457579970,0.4422809457579970
2024-09-27,2024,9,259,359,8,626,0.41373801916932900,0.41373801916932900
2024-09-28,2024,9,199,335,4,538,0.36988847583643100,0.36988847583643100
2024-09-29,2024,9,172,296,4,472,0.3644067796610170,0.3644067796610170
2024-09-30,2024,9,245,335,4,584,0.4195205479452060,0.4195205479452060
2024-10-01,2024,10,429,484,5,918,0.4673202614379090,0.4673202614379090
2024-10-02,2024,10,450,558,10,1018,0.44204322200392900,0.44204322200392900
2024-10-03,2024,10,373,518,3,894,0.4172259507829980,0.4172259507829980
2024-10-04,2024,10,325,460,8,793,0.4098360655737710,0.4098360655737710
2024-10-05,2024,10,233,381,7,621,0.3752012882447670,0.3752012882447670
2024-10-06,2024,10,195,349,5,549,0.3551912568306010,0.3551912568306010
2024-10-07,2024,10,224,291,6,521,0.42994241842610400,0.42994241842610400
2024-10-08,2024,10,349,416,2,767,0.455019556714472,0.455019556714472
2024-10-09,2024,10,399,522,5,926,0.43088552915766700,0.43088552915766700
2024-10-10,2024,10,373,464,8,845,0.4414201183431950,0.4414201183431950
2024-10-11,2024,10,319,441,4,764,0.4175392670157070,0.4175392670157070
2024-10-12,2024,10,228,406,13,647,0.35239567233384900,0.35239567233384900
2024-10-13,2024,10,193,329,0,522,0.36973180076628400,0.36973180076628400
2024-10-14,2024,10,235,376,5,616,0.3814935064935070,0.3814935064935070
2024-10-15,2024,10,354,430,3,787,0.4498094027954260,0.4498094027954260
2024-10-16,2024,10,424,537,3,964,0.43983402489626600,0.43983402489626600
2024-10-17,2024,10,382,434,2,818,0.4669926650366750,0.4669926650366750
2024-10-18,2024,10,326,388,5,719,0.4534075104311540,0.4534075104311540
2024-10-19,2024,10,230,428,4,662,0.3474320241691840,0.3474320241691840
2024-10-20,2024,10,177,375,7,559,0.31663685152057200,0.31663685152057200
2024-10-21,2024,10,236,387,7,630,0.3746031746031750,0.3746031746031750
2024-10-22,2024,10,378,422,5,805,0.46956521739130400,0.46956521739130400
2024-10-23,2024,10,370,527,5,902,0.41019955654102000,0.41019955654102000
2024-10-24,2024,10,329,475,5,809,0.40667490729295400,0.40667490729295400
2024-10-25,2024,10,295,416,7,718,0.41086350974930400,0.41086350974930400
2024-10-26,2024,10,234,345,4,583,0.4013722126929670,0.4013722126929670
2024-10-27,2024,10,207,337,4,548,0.3777372262773720,0.3777372262773720
2024-10-28,2024,10,235,321,4,560,0.41964285714285700,0.41964285714285700
2024-10-29,2024,10,367,419,6,792,0.4633838383838380,0.4633838383838380
2024-10-30,2024,10,371,437,2,810,0.4580246913580250,0.4580246913580250
2024-10-31,2024,10,290,346,5,641,0.45241809672386900,0.45241809672386900
2024-11-01,2024,11,362,491,5,858,0.4219114219114220,0.4219114219114220
2024-11-02,2024,11,224,356,5,585,0.38290598290598300,0.38290598290598300
2024-11-03,2024,11,212,306,5,523,0.40535372848948400,0.40535372848948400
2024-11-04,2024,11,319,380,12,711,0.44866385372714500,0.44866385372714500
2024-11-05,2024,11,266,379,7,652,0.40797546012269900,0.40797546012269900
2024-11-06,2024,11,376,491,10,877,0.42873432155074100,0.42873432155074100
2024-11-07,2024,11,367,494,10,871,0.4213547646383470,0.4213547646383470
2024-11-08,2024,11,299,465,9,773,0.3868046571798190,0.3868046571798190
2024-11-09,2024,11,223,416,5,644,0.34627329192546600,0.34627329192546600
2024-11-10,2024,11,198,355,9,562,0.35231316725978600,0.35231316725978600
2024-11-11,2024,11,216,382,4,602,0.3588039867109640,0.3588039867109640
2024-11-12,2024,11,441,454,6,901,0.4894561598224200,0.4894561598224200
2024-11-13,2024,11,432,521,3,956,0.45188284518828500,0.45188284518828500
2024-11-14,2024,11,430,549,10,989,0.43478260869565200,0.43478260869565200
2024-11-15,2024,11,360,485,6,851,0.42303172737955300,0.42303172737955300
2024-11-16,2024,11,263,417,11,691,0.38060781476121600,0.38060781476121600
2024-11-17,2024,11,186,377,4,567,0.328042328042328,0.328042328042328
2024-11-18,2024,11,309,366,4,679,0.45508100147275400,0.45508100147275400
2024-11-19,2024,11,442,476,5,923,0.4788732394366200,0.4788732394366200
2024-11-20,2024,11,418,516,2,936,0.4465811965811970,0.4465811965811970
2024-11-21,2024,11,368,427,4,799,0.46057571964956200,0.46057571964956200
2024-11-22,2024,11,267,448,4,719,0.3713490959666200,0.3713490959666200
2024-11-23,2024,11,250,434,6,690,0.36231884057971000,0.36231884057971000
2024-11-24,2024,11,226,399,5,630,0.35873015873015900,0.35873015873015900
2024-11-25,2024,11,302,366,3,671,0.45007451564828600,0.45007451564828600
2024-11-26,2024,11,342,477,5,824,0.41504854368932000,0.41504854368932000
2024-11-27,2024,11,285,406,2,693,0.41125541125541100,0.41125541125541100
2024-11-28,2024,11,105,153,0,258,0.4069767441860470,0.4069767441860470
2024-11-29,2024,11,259,482,5,746,0.34718498659517400,0.34718498659517400
2024-11-30,2024,11,259,426,10,695,0.3726618705035970,0.3726618705035970
2024-12-01,2024,12,206,353,5,564,0.36524822695035500,0.36524822695035500
2024-12-02,2024,12,320,355,7,682,0.46920821114369500,0.46920821114369500
2024-12-03,2024,12,393,526,5,924,0.4253246753246750,0.4253246753246750
2024-12-04,2024,12,336,493,5,834,0.4028776978417270,0.4028776978417270
2024-12-05,2024,12,365,427,10,802,0.4551122194513720,0.4551122194513720
2024-12-06,2024,12,304,463,5,772,0.39378238341968900,0.39378238341968900
2024-12-07,2024,12,225,406,10,641,0.35101404056162200,0.35101404056162200
2024-12-08,2024,12,211,350,4,565,0.3734513274336280,0.3734513274336280
2024-12-09,2024,12,263,326,3,592,0.44425675675675700,0.44425675675675700
2024-12-10,2024,12,355,457,7,819,0.43345543345543300,0.43345543345543300
2024-12-11,2024,12,301,435,2,738,0.4078590785907860,0.4078590785907860
2024-12-12,2024,12,332,421,1,754,0.4403183023872680,0.4403183023872680
2024-12-13,2024,12,281,400,4,685,0.41021897810219000,0.41021897810219000
2024-12-14,2024,12,194,354,6,554,0.35018050541516200,0.35018050541516200
2024-12-15,2024,12,190,360,2,552,0.3442028985507250,0.3442028985507250
2024-12-16,2024,12,222,311,4,537,0.4134078212290500,0.4134078212290500
2024-12-17,2024,12,393,451,8,852,0.4612676056338030,0.4612676056338030
2024-12-18,2024,12,343,414,5,762,0.45013123359580100,0.45013123359580100
2024-12-19,2024,12,325,452,4,781,0.41613316261203600,0.41613316261203600
2024-12-20,2024,12,275,380,4,659,0.417298937784522,0.417298937784522
2024-12-21,2024,12,186,365,6,557,0.3339317773788150,0.3339317773788150
2024-12-22,2024,12,191,323,2,516,0.3701550387596900,0.3701550387596900
2024-12-23,2024,12,218,327,2,547,0.39853747714808000,0.39853747714808000
2024-12-24,2024,12,128,177,0,305,0.419672131147541,0.419672131147541
2024-12-25,2024,12,112,171,0,283,0.3957597173144880,0.3957597173144880
2024-12-26,2024,12,257,413,4,674,0.38130563798219600,0.38130563798219600
2024-12-27,2024,12,270,407,3,680,0.39705882352941200,0.39705882352941200
2024-12-28,2024,12,206,426,11,643,0.3203732503888030,0.3203732503888030
2024-12-29,2024,12,239,371,5,615,0.3886178861788620,0.3886178861788620
2024-12-30,2024,12,245,342,1,588,0.4166666666666670,0.4166666666666670
2024-12-31,2024,12,188,257,1,446,0.42152466367713000,0.42152466367713000